
!	sf
!GIHO	sy
"	sl	sr
$	su
%	su
'	sl	sr
(	sl
(KS)	sy
(주)	ncn
(주)대우	nqq
)	sr
*	sy
,	sp
-	sd
->	sy
.	sf	sy
...	se
......	se
/	sp
007시리즈	ncn
1.21	nqq
1.21사태	nqq
1.21청와대기습기도사건	nqq
1.22	nqq
1.22공동선언	nqq
1.22선언	nqq
1.22정계개편	nqq
1.22정재편	nqq
1.22합당	nqq
1.22합당선언	nqq
10.15선거	nqq
10.26	nqq
10.26사건	nqq
10.26사태	nqq
10.26시해사건	nqq
10.26정변	nqq
10.26쿠데타	nqq
100가지	ncn
10대	ncn
10대가수	ncn
10대그룹	ncn
10대뉴스	ncn
10대청소년	ncn
10부제	ncn
10부제운행	ncn
10세기	nqq
10월유신	nqq
10월혁명	ncn
10종경기	ncn
10차선	ncn
114	ncn
119	ncn
11세기	nqq
12.12	ncn
12.12군사반란	nqq
12.12군사쿠데타	nqq
12.12반란	nqq
12.12사건	nqq
12.12사태	ncn
12.12쿠데타	nqq
129센터	ncn
129응급센터	ncn
12세기	nqq
12지	ncn
13대대선	nqq
13대총선	nqq
13대총선거	nqq
13세기	ncn
14대	ncn
14대국회의원선거	nqq
14대대선	nqq
14대대통령선거	nqq
14대총선	nqq
14대총선거	nqq
14세	ncn
14세기	nqq
14총선	nqq
15대	ncn
15세기	nqq
16강	ncn
16강전	ncn
16세	ncn
16세기	nqq
16주기	ncn
17세기	ncn
18세기	nqq
1937년	ncn
19세기	ncn
1tv	ncn
1가구1주택	ncn
1관왕	ncn
1당독재	ncn
1등서기관	ncn
1등석	ncn
1루수	ncn
1부리그	ncn
1분기	ncn
1세	ncn
1세기	nqq
1원화	ncn
1인당	ncn
1인당GNP	ncn
1인당생산성	ncn
1인자	ncn
1점홈런	ncn
1차관보	ncn
1차대전	ncn
1차대회	ncn
1차세계대전	ncn
1쿼터	ncn
1호선	ncn
1호업체	ncn
1회용기저귀	ncn
1회용면도기	ncn
1회용젓가락	ncn
1회용주사기	ncn
1회용품	ncn
2*4	ncn
2*4경골구조	ncn
2.8	nqq
2.8독립선언운동	nqq
2000학번	ncn
2002년	ncn
208영동호	ncn
20대	ncn
20세기	ncn
20세기폭스	ncn
21세기	ncn
21세기위원회	ncn	nqq
21세미만주니어축구대회	nqq
21신진호	ncn
24시간영업	ncn
24시간편의점	ncn
24절기	ncn
2tv	ncn
2관왕	ncn
2국	ncn
2군감독	ncn
2군사령관	ncn
2단로켓	ncn
2대악법반대투쟁	nqq
2루수	ncn
2루수플라이	ncn
2백해리	ncn
2부제	ncn
2부제수업	ncn
2세	ncn
2세경영	ncn
2세경영체제	ncn
2세교육	ncn
2세기	nqq
2연패	ncn
2원화	ncn
2인자	ncn
2중	ncn
2중고	ncn
2중과세방지협정	ncn
2중장부	ncn
2중주단	ncn
2지구	ncn
2진급투수	ncn
2차대전	ncn
2차방어전	ncn
2차세계대전	ncn
2차회담	ncn
2쿼터	ncn
2플러스4회담	nqq
2호선	nqpc
2회전	ncn
3.1	nqq
3.1독립만세	nqq
3.1독립만세운동	nqq
3.1독립운동	nqq
3.1만세	nqq
3.1만세운동	ncn
3.1문화상	ncn
3.1민주구국선언	ncn
3.1민주구국선언사건	nqq
3.1운동	ncn
3.1운동관	ncn
3.1의거	nqq
3.1절	ncn
3.1항쟁	nqq
3.1혁명	nqq
3.24데모	nqq
30대그룹	ncn
35mm	ncn
38선	ncn
3D기피현상	ncn
3D업종	ncn
3D현상	ncn
3고	ncn
3고시대	ncn
3공이후	ncn
3관왕	ncn
3김	ncn
3김시대	ncn
3년생	ncn
3단로켓	ncn
3당보수연합	nqq
3당야합	ncn
3당연합	nqq
3당통합	ncn
3당합당	ncn
3당합동	nqq
3루수	ncn
3백년을	ncn
3부작	ncn
3선개헌	nqq
3선개헌반대투쟁	nqq
3성장군	ncn
3세기	nqq
3역회의	ncn
3월	nqq
3인조	ncn
3자간협정	ncn
3자개입	ncn
3자회담	ncn
3저	ncn
3저시대	ncn
3점슛	ncn
3점포	ncn
3점홈런	ncn
3중주단	ncn
3차대전	ncn
3차산업	ncn
3차세계대전	ncn
3차전	ncn
3쿼터	ncn
3학년생	ncn
3호선	nqpc
4.11	ncn
4.11총선	ncn
4.13호헌조치	nqq
4.19	ncn
4.19데모	nqq
4.19묘소	nqq
4.19묘역	nqq
4.19민주혁명	nqq
4.19의거	nqq
4.19지	nqq
4.19학생혁명	nqq
4.19혁명	nqq
4.26	nqq
4.26총선	nqq
4.26총선거	nqq
4.27선거	nqq
4.3	nqq
4.3보궐선거	nqq
4.3봉기	nqq
4.3사건	nqq
4.3사태	nqq
4.3선거	nqq
4.3제주항쟁	nqq
4.3폭동	nqq
4.3항쟁	nqq
40대	ncn
42번가	ncn
4강	ncn
4강대결	ncn
4강전	ncn
4단오토	ncn
4대강	ncn
4대강오염	ncn
4세기	nqq
4연패	ncn
4인가족	ncn
4인방	ncn
4자연합	ncn
4자회담	ncn
4중주단	ncn
4쿼터	ncn
4호선	nqpc
5.16	ncn
5.16광장	nqq
5.16군사구테타	nqq
5.16군사쿠데타	nqq
5.16군사쿠테타	nqq
5.16민족상	nqq
5.16상	nqq
5.16쿠데타	nqq
5.16통지	ncn
5.16혁명	nqq
5.17	ncn
5.17계엄	nqq
5.17비상계엄확대조치	nqq
5.18	ncn
5.18광주민주항쟁	nqq
5.18광주민주화운동	nqq
5.18광주민주화항쟁	nqq
5.18광주민중항쟁	ncn
5.18광주사태	nqq
5.18광주의거	nqq
5.18광주항쟁	nqq
5.18묘역	nqq
5.18묘역제단	nqq
5.18민주항쟁	nqq
5.18민주화운동	nqq
5.18민중운동	nqq
5.18민중항쟁	nqq
5.18사태	nqq
5.18시위	nqq
5.18의거	nqq
5.18특별법	ncn
5.18항쟁	nqq
5.18희생자묘역	nqq
58대책	ncn
58부동산대책	ncn
58부동산투기억제대책	ncn
58조치	ncn
5개년계획	ncn
5공	ncn
5공비리	ncn
5공비리사건	ncn
5공비리조사특별위원회	nqq
5공정권	ncn
5공정부	ncn
5공청문회	ncn
5공특위	nqq
5공화국	ncn
5대그룹	ncn
5세기	nqq
5월투쟁	ncn
5월혁명	nqq
5일제근무	ncn
5일제수업	ncn
5종경기	ncn
5중주단	ncn
5호선	ncn
6.1	nqq
6.10국민항쟁	nqq
6.10대회	nqq
6.10만세사건	nqq
6.10만세운동	ncn
6.10민중항쟁	nqq
6.10시민항쟁	nqq
6.10항쟁	nqq
6.25	nqq
6.25남침	nqq
6.25동란	ncn
6.25사변	nqq
6.25전쟁	nqq
6.29	nqq
6.29선언	nqq
6.29현상	ncn
6.3빌딩	nqq
6.3항쟁	nqq
6.4	nqq
6.4사건	nqq
6.4사태	nqq
6.4천안문사건	nqq
6.4천안문사태	nqq
63빌딩	ncn
63빌딩체크	nqq
6공	ncn
6공비리	ncn
6공비리사건	ncn
6공비리청문회	nqq
6공정권	ncn
6공정부	ncn
6공청문회	ncn
6공화국	ncn
6대국회	ncn
6대도시	ncn
6대도시지역	ncn
6세기	nqq
6월민주항쟁	nqq
6월민주화운동	nqq
6월민주화항쟁	nqq
6월항쟁	nqq
6호선	nqpc
77인	ncn
7단계	ncn
7백년전의	ncn
7세기	nqq
7전4선승제	ncn
7호선	nqpc
8.15	nqq
8.15광복절	nqq
8.15민족해방	nqq
8.15범민족대회	nqq
8.15해방	nqq
88	ncn
88년서울올림픽	nqq
88도로	nqq
88서울올림픽	nqq
88서울올림픽공원	nqq
88올림픽	nqq
88올림픽대로	nqq
88올림픽도로	nqq
88잔디마당	ncn
8x8	nqq
8x8사	nqq
8강	ncn
8강전	ncn
8세기	nqq
8학군	ncn
8학군증후군	ncn
8호선	nqpc
900경해호	ncn
92년	ncn
96유럽축구선수권대회	ncn
96한국남자테니스서킷	ncn
97학년도	ncn
9기	ncn
9세기	nqq
9월의	ncn
:	sp
;	sy
<	sl
<->	sy
=	sy
>	sr
?	sf
@	sy
ABC제도	ncn
ABM	ncn
ABS	ncn
AFP	ncn
AFPAP	ncn
AFTA	ncn
AIDS	ncn
AIDS감염	ncn
AIDS감염자	ncn
AIDS검사	ncn
AIDS백신	ncn
AIDS치료제	ncn
AIDS환자	ncn
AM	ncn
AM방송	ncn
AP	ncn
AT&T	nqq
ATM	ncn
AV	ncn
AV기기	ncn
AV시스템	ncn
AWACS	ncn
B/L	ncn
BBS	nqq
BCG접종	ncn
BL	ncn
BMF	ncn
BMW	nqq
BMW자동차	nqq
BOD	ncn
BSI	ncn
BYC	nqq
Bill	f
B형간염	ncn
B형간염백신	ncn
CATV	ncn
CATV사업	ncn
CB	ncn
CCTV	ncn
CD	ncn
CDP	ncn
CD금리	ncn
CD발행	ncn
CD플레이어	ncn
CF	ncn
CFC	ncn
CF모델	ncn
CIS	nqq
CM	ncn
CMA	ncn
CNN뉴스	nqq
COD	ncn
COMECON	nqq
CP	ncn
CSCE	nqq
CT	ncn
CVS	ncn
CY	nqq
Clinton	f
Co.	sy
DACOM	nqq
DAT	ncn
DB저작권	ncn
DIY상품	ncn
DJ	nqq
DMZ	ncn
DNA	ncn
DO	ncn
DPA	ncn
DTP	ncn
EBS	nqq
EBS청소년창작가요제	nqq
EC	ncn
EC경제	ncn
EC경제통합	ncn
EC국가	ncn
EC단일시장	ncn
EC무역	ncn
EC의장국	ncn
EC정상회담	ncn
EC통합	ncn
EC통합군	ncn
EC통화	ncn
EEA	ncn
EMS	ncn
ETRI	nqq
EU	nqq
EU경제	ncn
EU경제통합	ncn
EU국가	ncn
EU단일시장	ncn
EU무역	ncn
EU의장국	ncn
EU통합	ncn
EU통합군	ncn
EXPO93	nqq
Esperanto	f
E마크	ncn
F-14	nqq
F-14전투기	nqq
F-15	nqq
F-15전투기	nqq
F-16	nqq
F-16전투기	nqq
F14	nqq
F14전투기	nqq
F15	nqq
F15전투기	nqq
F16	nqq
F16전투기	nqq
FA컵축구대회	nqq
FM	ncn
FMS	ncn
FM방송	ncn
FRP	ncn
FX전투기	ncn
F아이스스케이트	ncn
G7	ncn
G7연구사업	ncn
G7정상회담	ncn
G7프로젝트	ncn
G8	ncn
GDP	f
GND	ncn
GNP	ncn
GNP성장률	ncn
GNP증가율	ncn
GSP	ncn
GUESS	nqq
HAN_CHI	ncn
HAN_ENG	f
HDTV	ncn
HITEL	nqq
HIV	ncn
IAC	nqq
IAEA	ncn
IAEA사찰	ncn
IAEA탈퇴	ncn
IAEA핵사찰	ncn
IAEA핵안전협정	ncn
IBM	nqq
IBMPC	nqq
IBM개인용컴퓨터	nqq
IBM사	nqq
IBM컴퓨터	nqq
ICBM	ncn
ICE	ncn
IE	ncn
INF	ncn
IQ	ncn
IQ검사	ncn
IRA	ncn
IRBM	ncn
JFK	nqq
JFK공항	nqq
JP	nqq
KAERI	nqq
KAIST	nqq
KAL	nqq
KAL007기피격사건	nqq
KAL기	ncn
KAL기격추사건	nqq
KAL기사건	nqq
KAL기폭파사건	nqq
KAL빌딩방화사건	nqq
KBS	nqq
KBSTV	nqq
KBS라디오	nqq
KBS사태	nqq
KBS파업	nqq
KDI	nqq
KEDI	nqq
KIEP	nqq
KIET	nqq
KIST	nqq
KNCC	nqq
KOC	nqq
KOEX	ncn
KPC	nqq
KRNET	nqq
KS	ncn
KS규격	ncn
KS마크	ncn
KS표시	ncn
KTA	nqq
Kg	su
LA	nqq
LA공항	nqq
LA국제공항	nqq
LA기어	nqq
LA올림픽	nqq
LA폭동	nqq
LA한인타운	ncn
LA흑인폭동	nqq
LC	ncn
LD	ncn
LDP	ncn
LG	nqq
LNG	ncn
LNG비축기지	ncn
LNG선	ncn
LP	ncn
LPG	ncn
LP가스	ncn
LSD	ncn
M16	ncn
MBA	ncn
MBC	nqq
MBCTV	nqq
MBC라디오	nqq
MBC사태	nqq
MBC파업	nqq
MC	ncn
MCM	nqq
MFA	ncn
MSG	ncn
MTB	ncn
MVP	ncn
NAM	ncn
NATO회원국	ncn
NBA	ncn
NCC	nqq
NFL	ncn
NICS	ncn
NIES	ncn
NNP	ncn
NPT	ncn
NPT조약	ncn
NPT체제	ncn
NPT탈퇴	ncn
NSC	nqq
No.	sy
OA기기	ncn
OB	nqq
OB맥주	nqq
OB아이스	nqq
OB아이스맥주	nqq
OEM	ncn
OEM방식	ncn
OEM수입	ncn
OEM수출	ncn
OO	se
OOO	se
OPM	nqq
PBC	nqq
PCB	ncn
PCB공해	ncn
PCB오염	ncn
PC주택	ncn
PC통신천리안	nqq
PC통신하이텔	nqq
PD	ncn
PE	ncn
PEN	ncn
PKO	ncn
PKO파병	ncn
PKO활동	ncn
POSCO	nqq
PP	ncn
PQ	nqq
PR	ncn
PVC	ncn
PX	ncn
Q.C	ncn
REL_TYPE=NT	nqq
ROTC	ncn
ROTC장교	ncn
RP	ncn
SALT	ncn
SBS	nqq
SDI	ncn
SFX영화	ncn
SF소설	ncn
SF영화	ncn
SICAF	nqq
SICHEM	nqq
SKC	nqq
SOC	ncn
SOC투자	ncn
SOFA	ncn
SSC	ncn
START	ncn
TBC	nqq
TBS	nqq
TGV	ncn
TK	ncn
TK세력	ncn
TK인맥	ncn
TK인사	ncn
TK정권	ncn
TM.	sy
TNT	ncn
TV	ncn
TV경마	ncn
TV경마장	ncn
TV고교가정학습	ncn
TV과외	ncn
TV광고	ncn
TV난시청	ncn
TV뉴스	ncn
TV드라마	ncn
TV모니터	ncn
TV방송	ncn
TV방송국	ncn
TV방송사	ncn
TV부품	ncn
TV수신료	ncn
TV시청률	ncn
TV연설	ncn
TV연설회	ncn
TV연속극	ncn
TV유세	ncn
TV정치방송	ncn
TV중계	ncn
TV토론	ncn
TV토론회	ncn
TV프로	ncn
TV프로그램	ncn
TV회의	ncn
Tel.	sy
T셔츠	ncn
UFO	ncn
UF병해충	ncn
UIP직배	ncn
UIP직배파문	ncn
UN	ncn
UNCTAD	nqq
UNDP	ncn
UNEP	ncn
UNIX	nqq
UN가입	ncn
UN총회	ncn
UN탈퇴	ncn
UN평화유지군	ncn
UPI	ncn
UR대책	ncn
UR협상	ncn
UR협정	ncn
USA	nqq
USA투데이	nqq
USA투데이지	nqq
VCR	ncn
VTR	ncn
XX	se
XXX	se
X선	ncn
YMCA	nqq
YMCA연맹	nqq
YS	nqq
YS그룹	ncn
YS세력	ncn
YS진영	ncn
YWCA	nqq
YWCA연합회	nqq
[	sl
\"	sl	sr
]	sr
^	sy
`	sl
a1	ncn
a1등급	ncn
abs	ncn
ad	ncn
adb	ncn
adults	ncn
afc	ncn
afkn	ncn
aid	ncn
aids	ncn
aid개량분석연구소장	ncn
air	ncn
am.	sy
amps	ncn
an	ncn
and	ncn
andrew	ncn
anjar	ncn
anything	ncn
aol	ncn
ap	ncn
apart	ncn
apec	ncn
ap통신	ncn
aqmd	ncn
are	ncn
arm	ncn
armdaun	ncn
arrow	ncn
asean	ncn
asem	ncn
asem회의	ncn
asian	ncn
asic	ncn
at	ncn
at&t	ncn
at&t사	ncn
atp	ncn
avenger	ncn
aw	ncn
a클래식	ncn
baalbek	ncn
bansong	ncn
bart	ncn
bbc	ncn
bbc방송	ncn
bbs	ncn
beauty	ncn
bed	ncn
between	ncn
bill	ncn
bjp	ncn
blocking	ncn
bmcn	ncn
bmg	ncn
bmw	ncn
bod	ncn
body	ncn
bora	ncn
box	ncn
brand	ncn
broken	ncn
business	ncn
but	ncn
by	ncn
byblos	ncn
ca	ncn
caa	ncn
california	ncn
calim	ncn
calim사	ncn
cals	ncn
cam	ncn
can	ncn
capital	ncn
car	ncn
cbs	ncn
cc	ncn
cctv	ncn
cd	ncn
cdma	ncn
cdma방식	ncn
cdr	ncn
cdu	ncn
cd공장	ncn
cd기	ncn
cd롬	ncn
cd롬드라이브	ncn
cebu	ncn
ceo	ncn
ceo레터	ncn
cf	ncn
cf감독	ncn
change	ncn
check	ncn
china	ncn
chink	ncn
chinks	ncn
chosun	ncn
christy	ncn
chung	ncn
ci	ncn
cia	ncn
cis	ncn
city	ncn
class	ncn
clinet	ncn
cm	su
cma	ncn
cnn	ncn
cnn방송	ncn
cnrs	ncn
co	ncn
cocos	ncn
cod	ncn
coled	ncn
com	ncn
commerce	ncn
compuserve	ncn
consenting	ncn
cpi	ncn
cpt	ncn
cpu	ncn
cross	ncn
csis	ncn
ct	ncn
ctbt	ncn
cultural	ncn
customer	ncn
dacom	ncn
dark	ncn
dataq	ncn
david	ncn
day	ncn
days	ncn
dc	ncn
demand	ncn
demarkation	ncn
deterrence	ncn
dgb	ncn
diary	ncn
distinguish	ncn
distri	ncn
dj	ncn
dl사장	ncn
dm	ncn
dmi	ncn
dmz	ncn
dna	ncn
dna샘플	ncn
do	ncn
dohc	ncn
drop	ncn
dso	ncn
dyp	ncn
d램	ncn
eagle	ncn
ebs	ncn
eco	ncn
ecu	ncn
edi	ncn
edu	ncn
edutainment	ncn
eez	ncn
eight	ncn
el	ncn
electronic	ncn
emi	ncn
eml	ncn
ems	ncn
en	ncn
engagement	ncn
ent	ncn
entertainment	ncn
estima	ncn
et	ncn
eu	nqq
euro1996	ncn
exchange	ncn
exit	ncn
expo	ncn
expo전시구역	ncn
extraterrestrial	ncn
eyed	ncn
fa	ncn
faa	ncn
fact	ncn
fake	ncn
fao	ncn
fargo	ncn
fashion	ncn
fa컵	ncn
fbi	ncn
fi	ncn
fiber	ncn
fifa	ncn
figure	ncn
finely	ncn
firm	ncn
fm	ncn
foever	ncn
for	ncn
forest	ncn
frb	ncn
from	ncn
fso	ncn
ft	su
ftp	ncn
funny	ncn
futurekids	ncn
fw	ncn
g7	ncn
g8	ncn
gateway	ncn
gbps	ncn
gc	ncn
gdp	f
ge	ncn
geokorad	ncn
gift	ncn
gingko	ncn
girl	ncn
gk	ncn
global	ncn
gm	ncn
go	ncn
gp	ncn
gps	ncn
grims	ncn
gyn	ncn
habitus	ncn
hall	ncn
have	ncn
hdd	ncn
he	ncn
headed	ncn
headlines	ncn
heidelberg	ncn
help	ncn
hey	ncn
high	ncn
highway	ncn
hirak	ncn
hnc	ncn
homepages	ncn
hs	ncn
htm	ncn
html	ncn
http	ncn
huitieme	ncn
iaea	ncn
ibf	ncn
ibf헤비급	ncn
ibm	ncn
ic	ncn
ico	ncn
id	ncn
ifpi	ncn
ig	ncn
ilt	ncn
ilt사	ncn
imaginary	ncn
imf	ncn
img	ncn
ims	ncn
in	ncn
ing	ncn
inko	ncn
innocence	ncn
intelligence	ncn
inter	ncn
internetizen	ncn
internotes	ncn
inversus	ncn
ip	ncn
ipa	ncn
ipr	ncn
is	ncn
isi	ncn
iso	ncn
it	ncn
iti	ncn
jaebol	ncn
japs	ncn
jaune	ncn
java	f
jb0	ncn
jbo	ncn
jfax	ncn
jfk	ncn
jfk공항	nqq
jinps	ncn
jive	ncn
jod	ncn
john	ncn
jour	ncn
jp	ncn
jslee	ncn
juror	ncn
just	ncn
juxtaposition	ncn
j팩스사	ncn
j팩스커뮤니케이터	ncn
kaist	ncn
kansas	ncn
kbo	ncn
kbs	ncn
kbs1	ncn
kbs2tv	ncn
kdi	ncn
kedo	ncn
ketel	ncn
kfc	ncn
kfda	ncn
kg	su
khba	ncn
kid	ncn
kidnet	ncn
kids	ncn
kiet	ncn
killed	ncn
kim	ncn
kist	ncn
kitel	ncn
kkk	ncn
klo	ncn
km	su
km^2	su
kmtv	ncn
ko	ncn
koex	ncn
koreans	ncn
kornet	ncn
kotra	ncn
ko승	ncn
kr	ncn
krnet	ncn
kt	ncn
kt-net	ncn
kwan	ncn
la	ncn
lan	ncn
landing	ncn
language	ncn
later	ncn
la공항	nqq
la국제공항	nqq
la다저스	ncn
la아리랑	ncn
la올림픽	ncn
la주재원	ncn
la필하모닉	ncn
lcd	ncn
le	ncn
leo	ncn
lf	ncn
lg	ncn
lg-eds	ncn
lght	ncn
lgii	ncn
lg건설	ncn
lg경제연구원	ncn
lg구단	ncn
lg그룹	ncn
lg미디어	ncn
lg반도체	ncn
lg산전	ncn
lg스포츠	ncn
lg신용카드	ncn
lg애드	ncn
lg인포콤	ncn
lg전자	ncn
lg정보통신	ncn
lg정유	ncn
lg정유유통	ncn
lg정유판매	ncn
lg칼텍스정유	ncn
lg트윈스	ncn
lg패션	ncn
lg화재	ncn
lg화학	ncn
lies	ncn
life	ncn
light	ncn
line	ncn
lists	ncn
live	ncn
llt	ncn
lng	ncn
lng선	ncn
lng수송선	ncn
local	ncn
looking	ncn
lot	ncn
lots	ncn
lp	ncn
lute	ncn
m&a	ncn
m&a관련주	ncn
m&a주	ncn
m93r	ncn
m^2	su
machine	ncn
mact	ncn
mahnoo	ncn
make	ncn
man	ncn
management	ncn
manager	ncn
mba	ncn
mbc	ncn
mc	ncn
mca	ncn
mci	ncn
mci사	ncn
md	ncn
mdl	ncn
mean	ncn
media	ncn
mer	ncn
mfn	ncn
mg	su
michelle	ncn
milestone	ncn
million	ncn
millitary	ncn
minorities	ncn
minute	ncn
minutes	ncn
missester	ncn
mit	ncn
mlb	ncn
mm	su
money	ncn
moral	ncn
motor	ncn
mou	ncn
mpact	ncn
msn	ncn
mtb	ncn
mtv	ncn
mugimo	ncn
musical	ncn
mustang	ncn
mvp	ncn
myth	ncn
nafta	ncn
name	ncn
napa	ncn
nasa	ncn
national	ncn
nba	ncn
nbc	ncn
ncc	ncn
nderheart	ncn
nec	ncn
neonet	ncn
net	ncn
neti	ncn
netizen	ncn
nf	ncn
nf-lf	ncn
nfl	ncn
nflf	ncn
ng	su
ngo	ncn
nie	ncn
nies	ncn
nigger	ncn
nira	ncn
nk전자	ncn
nl	ncn
nm	ncn
no	ncn
note	ncn
notes	ncn
npfl	ncn
nrp	ncn
ob	ncn
ob맥주	ncn
ob씨그램	ncn
ochsen	ncn
oecd	ncn
oem	ncn
of	ncn
office	ncn
ok	ncn
old	ncn
olivier	ncn
om	ncn
on	ncn
one	ncn
only	ncn
optic	ncn
org	ncn
orientale	ncn
our	ncn
ourworld	ncn
pa	ncn
palengr	ncn
pallada	ncn
party	ncn
pass	ncn
pb	ncn
pc	ncn
pcs	ncn
pcs사업자	ncn
pc네트워크	ncn
pc칩	ncn
pc통신	ncn
pc통신망	ncn
pc통신서비스	ncn
pd	ncn
penman	ncn
perspective	ncn
pet	ncn
pet병	ncn
pga	ncn
pga투어	ncn
pk	ncn
plane	ncn
planning	ncn
plo	ncn
pluribus	ncn
pm.	sy
policy	ncn
post	ncn
pr	ncn
prc	ncn
pricing	ncn
private	ncn
prize	ncn
proj	ncn
p회전	ncn
quality	ncn
quiz	ncn
racial	ncn
ram	ncn
rapist	ncn
rca	ncn
real	ncn
respectable	ncn
restructering	ncn
revenge	ncn
riducule	ncn
rna	ncn
rotc	ncn
roter	ncn
rotunda	ncn
routing	ncn
rsb	ncn
rule	ncn
sa	ncn
san	ncn
santana	ncn
sbs	ncn
school	ncn
sci	ncn
sclc	ncn
search	ncn
secrets	ncn
sense	ncn
sepple	ncn
serch	ncn
seti	ncn
sex	ncn
shhwang	ncn
shop	ncn
shopkeeper	ncn
shot	ncn
show	ncn
sim	ncn
situa	ncn
situa-tion	ncn
situs	ncn
sjsu	ncn
skaters	ncn
skating	ncn
skc	ncn
sla	ncn
slit	ncn
slur	ncn
smaller	ncn
so	ncn
soback	ncn
soc	ncn
soft	ncn
solo	ncn
song	ncn
sorrow	ncn
sorry	ncn
source	ncn
speed	ncn
spj	ncn
sschool	ncn
staff	ncn
steal	ncn
stealing	ncn
stone	ncn
stop	ncn
storm	ncn
studentenkarzer	ncn
studies	ncn
sunchacer	ncn
sweet	ncn
symbolic	ncn
sympathy	ncn
s클래스	ncn
t1	ncn
t1급	ncn
t3	ncn
talk	ncn
tarantulas	ncn
tarp	ncn
tcp	ncn
tcp/ip	ncn
tell	ncn
test	f
tested	ncn
tf1	ncn
tft	ncn
that	ncn
the	ncn
them	ncn
there	ncn
these	ncn
they	ncn
thu	ncn
ti	ncn
tion	ncn
tk	ncn
to	ncn
toeic	ncn
together	ncn
tour	ncn
tpn	ncn
transportation	ncn
traveller	ncn
trs	ncn
tsd	ncn
tsd엔진	ncn
tsk	ncn
tv	ncn
tv공장	ncn
tv드라마	ncn
tv문학관	ncn
tv방송국	ncn
tv연예	ncn
tyr	ncn
uc	ncn
ucla	ncn
uefa	ncn
uejo	ncn
ulimo-j	ncn
ulm	ncn
ulp	ncn
ultra	ncn
umn	ncn
un	ncn
undp	ncn
unhcr	ncn
unido	ncn
unite	ncn
unum	ncn
unuson	ncn
ur	ncn
ur파동	ncn
us	ncn
usa	ncn
usis	ncn
ustr	ncn
us오픈	ncn
value	ncn
vcd	ncn
vcr	ncn
vietnamese	ncn
vip	ncn
vision	ncn
vital	ncn
vitali	ncn
vod	ncn
vod서비스	ncn
vtr	ncn
wan	ncn
watch	ncn
watchcon	ncn
wauthor1	ncn
wba	ncn
wbc	ncn
we	ncn
west	ncn
wfp	ncn
what	ncn
white	ncn
witloof	ncn
wjc	ncn
woz	ncn
wsj	ncn
wta	ncn
wto	ncn
www	ncn
x-ray	ncn
yahoo	ncn
yamaguchi	ncn
yd	su
year	ncn
yes	ncn
you	ncn
your	ncn
ys	ncn
ytn	ncn
ywca	ncn
z3	ncn
zen	ncn
zoo	ncn
{	sl
}	sr
~	sd
가	jcc	jcs	nqpa	pvg	px
가가	ncn
가가대소	ncpa
가가미타로	nqpc
가감	ncpa
가감산	ncpa
가감산기	ncn
가거도	nqq
가건물	ncn
가건희	nqpc
가게	ncn
가게일	ncn
가게주인	ncn
가격	ncn	ncpa	ncps
가격개혁	ncpa
가격격차	ncn
가격결정	ncn
가격결정권	ncn
가격결정방식	ncn
가격경로	ncn
가격경쟁	ncpa
가격경쟁력	ncn
가격경쟁체제	ncn
가격공세시	ncn
가격관리제도	ncn
가격구조	ncn
가격규제	ncpa
가격기구	ncn
가격기준	ncn
가격내림세	ncn
가격단위	ncn
가격담합	ncn
가격대	ncn
가격대등	ncpa
가격대성능	ncn
가격대성능비	ncn
가격대성능비율	ncn
가격덤핑	ncpa
가격동향	ncn
가격메커니즘	ncn
가격문제	ncn
가격변동	ncpa
가격변동요인	ncn
가격변화	ncpa
가격변화요인	ncn
가격분쟁	ncpa
가격산정	ncn
가격상	ncn
가격상승	ncpa
가격수준	ncn
가격시비	ncn
가격신고제	ncn
가격실현	ncpa
가격싸움	ncpa
가격안정	ncn
가격안정대책	ncn
가격요소	ncn
가격우위	ncn
가격이론	ncn
가격인상	ncpa
가격인상약속	ncpa
가격인상요구	ncpa
가격인상요인	ncn
가격인하	ncpa
가격인하경쟁	ncpa
가격인하공략	ncpa
가격인하공세	ncpa
가격인하방침	ncn
가격인하분	ncn
가격인하요인	ncn
가격인하율	ncn
가격일반	ncn
가격자극	ncpa
가격자유화	ncn
가격자유화정책	ncn
가격자유화조치	ncn
가격자율화	ncn
가격재인상	ncpa
가격재조정	ncpa
가격저렴	ncps
가격저하	ncpa
가격전쟁	ncpa
가격정보	ncn
가격정책	ncn
가격제	ncn
가격제도	ncn
가격제시	ncpa
가격조건	ncn
가격조사	ncn
가격조정	ncpa
가격중심	ncn
가격지배력	ncn
가격지수	ncn
가격질서	ncn
가격차	ncn
가격차별화정책	ncn
가격차이	ncn
가격채산성	ncn
가격체계	ncn
가격총액	ncn
가격추이	ncn
가격통제	ncpa
가격파괴	ncpa
가격파동	ncn
가격평준화	ncpa
가격폭등	ncpa
가격폭락	ncpa
가격폭락사태	ncn
가격폭락여파	ncn
가격표	ncn
가격표시	ncn
가격표시제	ncn
가격하락	ncpa
가격하락세	ncn
가격할인	ncpa
가격혁명	ncn
가격협상	ncn
가격형성	ncpa
가격형태	ncn
가격환원	ncn
가격회복	ncpa
가견	ncn
가결	ncpa
가경	ncn
가경로	nqpc
가경순	nqpc
가계	ncn
가계경제	ncn
가계계승	ncpa
가계금전신탁	ncn
가계대출	ncpa
가계부	ncn
가계부기록	ncpa
가계부문	ncn
가계부업자금	ncn
가계부채	ncn
가계부채보유액	ncn
가계비	ncn
가계생활자금저축	ncpa
가계소득	ncn
가계소비	ncn
가계소비구조	ncn
가계소비지출	ncn
가계수표	ncn
가계약	ncpa
가계예금통장	ncn
가계예산	ncpa
가계우대	ncn
가계우대저축	ncn
가계우대적립신탁	ncn
가계우대정기적금	ncn
가계자금	ncn
가계저축	ncpa
가계저축률	ncn
가계저축보유액	ncn
가계저축보육액	ncn
가계저축성향	ncn
가계저축액	ncn
가계저축예금	ncn
가계저축행태	ncn
가계적립신탁	ncn
가계조사	ncn
가계종합예금	ncn
가계지출	ncpa
가계출	nqpc
가계특급대출	ncn
가고시마	nqq
가곡	ncn
가곡공부	ncpa
가곡부르	pvg.irrlu
가곡연주회	ncn
가곡작곡	ncpa
가공	ncn	ncpa
가공계좌	ncn
가공공장	ncn
가공공정	ncn
가공공정인력	ncn
가공과정	ncpa
가공기계	ncn
가공기법	ncn
가공기술	ncn
가공기술분야	ncn
가공기술자	ncn
가공능력	ncn
가공대상물	ncn
가공라인	ncn
가공무역	ncn
가공물	ncn
가공사업	ncn
가공산업	ncn
가공수준	ncn
가공수출	ncpa
가공시설	ncn
가공식품	ncn
가공업	ncn
가공업체	ncn
가공용	ncn
가공음식	ncn
가공인물	ncn
가공재	ncn
가공재고	ncn
가공조건	ncn
가공조립산업	ncn
가공조미료	ncn
가공지	ncn
가공처리	ncn
가공품	ncpa
가관	ncn
가관현	nqpc
가광현	nqpc
가교	ncn
가교역할	ncn
가구	nbu	ncn
가구가사용품	ncn
가구값	ncn
가구공동체	ncn
가구공장	ncn
가구구성	ncpa
가구구성비	ncn
가구매장	ncn
가구생활	ncpa
가구소득	ncn
가구속성	ncn
가구수요	ncn
가구시청률	ncn
가구업자	ncn
가구업체	ncn
가구인수	ncpa
가구인원	ncn
가구인원수	ncn
가구재	ncn
가구점	ncn
가구조직	ncpa
가구주소득	ncn
가구주연령	ncn
가구집	ncn
가구현	nqpc
가구회사	ncn
가국진	nqpc
가국현	nqpc
가군	ncn
가권순	nqpc
가귀현	nqpc
가극	ncn	ncpa
가극단	ncn
가극음악	ncn
가극작품	ncn
가근방	nqq
가금	ncn
가급적	mag	ncn
가기선	nqpc
가기순	nqpc
가기술분야	ncn
가기열	nqpc
가기찬	nqpc
가기천	nqpc
가기홍	nqpc
가까스로	mag
가까와지	pvg
가까워지	pvg
가까이	mag
가깝	paa.irrb
가꾸	pvg
가꾸어지	pvg
가끔	mag
가끔가다	mag
가끔씩	mag
가나	nqq
가나공사	nqq
가나공화국	nqq
가나모리	ncn
가나아트	ncn
가나안	nqq
가나안농군학교	ncn
가나안령	ncn
가나안행	ncn
가난	ncps
가난뱅이	ncn
가난설움	ncn
가내	ncn
가내공업	ncn
가내공장	ncn
가내노동	ncpa
가내생산	ncpa
가내생활	ncpa
가내수공업	ncn
가내영	nqq
가내전자출판	ncn
가냘프	paa
가네마루	nqpc
가네마루신	nqpc
가네모드	nqpc
가네코	nqpc
가네코겐지로	nqpc
가네코도쿠노스케	nqpc
가네코미쓰히로	nqpc
가네프	nqpc
가녀리	paa
가노	ncn
가노미치히코	nqpc
가농	nqq
가누	pvg
가느다랗	paa.irrh
가는가	ncn
가는길	ncn
가늘	paa
가늘죽	ncps
가늠	ncpa
가늠쇠	ncn
가능	ncn	ncpa	ncps
가능곡선	ncn
가능성	ncn
가능성곡선	ncn
가능성문제	ncn
가능성여부	ncn
가능세계	ncn
가능에너지	ncn
가능여부	ncn
가능인구	ncn
가능체	ncn
가능품목	ncn
가다듬	pvg
가다랭이	ncn
가다피	nqpc
가닥	nbu	ncn
가닥가닥	ncn
가닥쯤	ncn
가담	ncpa
가담세력	ncn
가담자	ncn
가당찮	paa
가닿	pvg
가대련	nqpc
가덕	ncn
가데마루	nqpc
가도	ncn
가도가도	mag
가돈	ncn
가동	ncpa
가동공장	ncn
가동대수	ncn
가동률	ncn
가동상태	ncn
가동시간	ncn
가동시스팀	ncn
가동예정	ncpa
가동자	ncn
가동정지	ncn
가동준비	ncpa
가동중단	ncpa
가동채비	ncpa
가동현	nqpc
가동현황	ncn
가동훈	nqpc
가두	ncn	pvg
가두데모	ncpa
가두리	ncn
가두방송	ncn
가두배포	ncn
가두시위	ncpa
가두역	ncn
가두캠페인	ncn
가두투쟁	ncpa
가두판매	ncn
가두학교	ncn
가두행진	ncpa
가둑령	nqq
가드	ncn
가드레일	ncn
가득	mag	ncps
가득가득	mag
가득담	pvg
가득염	nqq
가득차	paa
가득현	nqpc
가득히	mag
가든	ncn
가등	ncpa
가등굉일	nqpc
가등기	ncn
가등등기자	ncn
가등청정	nqq
가디건	ncn
가뜩	mag
가뜩이나	mag
가라사와	nqpc
가라사와순지로	nqpc
가라앉	pvg
가라앉히	pvg
가라오케	ncn
가라오케시스팀	ncn
가라지	ncn
가락	nbu	ncn
가락2동	ncn
가락국	nqq
가락국수	ncn
가락농수산물도매시장	ncn
가락농수산물시장	ncn
가락도매시장	ncn
가락동	ncn
가락동농산물시장	ncn
가락동농산물직판장	ncn
가락동농수산물도매시장	ncn
가락동농수산물센터	ncn
가락동농수산물시장	ncn
가락동농수산시장	ncn
가락동도매시장	ncn
가락동시장	ncn
가락본동	ncn
가락시장	ncn
가락지	ncn
가락토세레브로사이드	ncn
가락하이마트	nqq
가람	ncn	nqq
가람국민학교	nqq
가랑머리	ncn
가랑비	ncn
가랑이	ncn
가래	ncn
가래바지	ncn
가래자루	ncn
가래침	ncn
가랭이	ncn
가량	nbu	xsnu
가려내	pvg
가려움	ncn
가려움증	ncn
가려지	pvg
가련	ncn	ncpa	ncps
가련지서	ncn
가련히	mag
가렴주구	ncn
가령	mag
가례	ncn
가로	mag	ncn	pvg
가로놓	pvg
가로놓이	pvg
가로눕	pvg.irrb
가로대	ncn
가로대세로화면비	ncn
가로등	ncn
가로막	ncn	pvg
가로막대	ncn
가로막지	paa
가로막히	pvg
가로사회	ncn
가로서	pvg
가로선	ncn
가로세로	mag	ncn
가로세로비율	ncn
가로수	ncn
가로쓰기	ncn
가로젓	pvg.irrs
가로조직	ncpa
가로지르	pvg.irrlu
가로질리	pvg
가로채	pvg
가로채기	ncpa
가로축	ncn
가로형	ncn
가롯	nqq
가롯유다	nqq
가료	ncpa
가루	ncn
가루받이	ncn
가루비누	ncn
가루상태	ncn
가루이자	ncn
가루지기	ncn
가류주의	ncn
가르	pvg.irrlu
가르니에	nqq
가르댕	nqpc
가르뎅	nqpc
가르베	nqq
가르비	nqq
가르시아	nqq
가르치	pvg
가르침	ncn
가르키	pvg
가르킴말	ncn
가르텡	nqpc
가르트	nqq
가름	ncpa
가리	nbu	ncn	pvg
가리개	ncn
가리발디	nqpc
가리봉	nqq
가리어지	pvg
가리우	pvg
가리키	pvg
가리킴말	ncn
가림	ncn
가마	nbu	ncn
가마꾼	ncn
가마니	nbu	ncn
가마니때기	ncn
가마니틀	ncn
가마솥	ncn
가마우지	ncn
가마우지호	nqq
가마이시	nqq
가마지붕	ncn
가마체	nqpc
가마쿠라막부	ncn
가마쿠라시대	ncn
가마타	pvg
가마터	ncn
가만	ii	mag
가만두	pvg
가만석	nqpc
가만있	paa
가만있자	ii
가만히	mag
가말	nqpc
가말숙	nqpc
가말압델나세르	nqpc
가망	ncn
가망성	ncn
가맹	ncpa
가맹국	ncn
가맹비	ncn
가맹센터	ncn
가맹점	ncn
가맹점관리	ncpa
가맹점수	ncn
가맹조약	ncn
가메야마제이이찌	nqpc
가면	ncn
가면극	ncn
가면의	ncn
가명	ncn
가명거래	ncpa
가명거래자	ncn
가명계좌	ncn
가명예금	ncpa
가명제도	ncn
가명통장	ncn
가명현	nqpc
가묘	ncn
가무	ncpa
가무마당	ncn
가무잡잡	ncps
가문	ncn
가문비	ncn
가문비나무	ncn
가물	ncn	pvg
가물가물	mag
가물가물하	paa	pvg
가물거리	pvg
가물치	ncn
가뭄	ncn
가뭄피해	ncpa
가뭄현상	ncn
가뭇없	paa
가미	ncpa
가미가제식	ncn
가미시바이	ncn
가미영	nqpc
가미화	nqpc
가발	ncn
가발업체	ncn
가방	ncn
가방류	ncn
가뱅	nqq
가버나움	nqq
가버너스챔버	ncn
가벌	ncn
가벼움	ncn
가벼워지	pvg
가벼이	mag
가변	ncn
가변비용	ncn
가변성	ncn
가변속	ncn
가변요금제	ncn
가변요소	ncn
가변요인	ncn
가변자본	ncn
가변직경형	ncn
가변컨덴서	ncn
가볍	paa.irrb
가병목	nqpc
가보	ncn	pvg
가보로네	nqq
가복현	nqpc
가본	ncn
가봉	nqq
가봉공화국	nqq
가부	ncn
가부간	mag
가부장	ncn
가부장권	ncn
가부장적	ncn
가부장제	ncn
가부장제도	ncn
가부좌	ncpa
가분	nqpc
가불	ncpa
가브라스	nqpc
가브리아	nqpc
가브리엘	nqq
가브리엘마르케스	ncn
가브린	nqpc
가비리아	nqpc
가비리안	nqpc
가빌라	nqq
가빠	ncn
가뿐	ncps
가뿐히	mag
가쁘	paa
가사	ncn
가사구조	ncn
가사내용	ncn
가사노동	ncpa
가사문학론	ncn
가사서비스업	ncn
가사소송법	ncn
가사업장	ncn
가사용품	ncn
가사일	ncn
가사존중	ncpa
가사종사자	ncn
가사체	ncn
가산	ncn	ncpa
가산금	ncn
가산금리	ncn
가산노	nqpc
가산세	ncn
가상	ncn	ncpa	ncps
가상공간	ncn
가상디	nqq
가상사원	ncn
가상세계	ncn
가상적국	ncn
가상적군	ncn
가상전쟁시나리오	ncn
가상체험기법	ncn
가상현실	ncn
가상현실기법	ncn
가상회선	ncn
가상히	mag
가새지르	pvg.irrlu
가색	ncn
가서	ncpa
가석방	ncpa
가선	ncn
가선예	nqpc
가선화	nqpc
가설	ncn	ncpa
가설도로	ncn
가설물	ncn
가설사업	ncpa
가설설정	ncpa
가설정립	ncpa
가섭	nqpc
가섭원	nqq
가성	ncn
가성순	nqpc
가성자	nqpc
가성현	nqpc
가세	ncn	ncpa
가세잡	pvg
가세트	nqq
가소	ncps
가소성	ncn
가속	ncn	ncpa
가속기	ncn
가속기연구소	ncn
가속도	ncn
가속페달	ncn
가속화	ncn
가속화해	ncpa
가솔	ncn
가솔린	ncn
가솔린엔진	ncn
가솔화	ncpa
가수	ncn	ncpa
가수부문	ncn
가수분해	ncpa
가수분해요소	ncn
가수생활	ncpa
가수요	ncn
가수자	ncn
가순관	nqpc
가순례	nqpc
가순택	nqpc
가스	ncn
가스가마	ncn
가스개발	ncn
가스개발계획	ncpa
가스개폐기	ncn
가스계량기	ncn
가스공급	ncpa
가스공사	nqq
가스관	ncn
가스교환	ncpa
가스교환효율	ncn
가스기구	ncn
가스기기	ncn
가스난로	ncn
가스난방기	ncn
가스냄새	ncn
가스냉방기	ncn
가스누출사고	ncn
가스등	ncn
가스레인지	ncn
가스로	ncn
가스매장지대	ncn
가스배출허용기준	ncn
가스보일러	ncn
가스사	ncn
가스사고	ncn
가스생산설비	ncpa
가스세	ncn
가스쇼바	ncn
가스스토브	ncn
가스실	ncn
가스안전	ncn
가스안전공사	nqq
가스안전관리	ncn
가스안전점검	ncn
가스압력	ncn
가스업	ncn
가스온수	ncn
가스온수기	ncn
가스요금	ncn
가스전	ncn
가스전개발	ncn
가스중독	ncn
가스중독사고	ncn
가스총	ncn
가스통	ncn	nqq
가스펠	ncn
가스폭발	ncn
가스폭발현장	ncn
가스흡입	ncn
가슴	ncn
가슴깊	paa
가슴께	ncn
가슴넓이	ncn
가슴둘레	ncn
가슴벅차	paa
가슴부상때문	ncn
가슴부위	ncn
가슴뼈	ncn
가슴쓰라리	paa
가슴아래	ncn
가슴아파하	paa
가슴아프	paa
가슴앓이	ncn
가슴통증	ncn
가슴팍	ncn
가습	ncpa
가습기	ncn
가습기능	ncn
가습기생산라인	ncn
가습기속	ncn
가습기시장	ncn
가습시	ncn
가승	ncn
가승서	ncn
가시	ncn
가시광선	ncn
가시권	ncn
가시기	ncn
가시나무	ncn
가시내	ncn
가시덤불	ncn
가시리	nqq
가시방석	ncn
가시밭길	ncn
가시성	ncn
가시역	ncn
가시옹	nqq
가시울타리	ncn
가시철망	ncn
가시청권	ncn
가시청세대수	ncn
가시청자	ncn
가시청지역	ncn
가시화	ncpa
가식	ncpa
가신	ncn
가신주의	ncn
가신현	nqpc
가실	ncn
가심	ncn
가십	ncn
가쓰나리	nqpc
가쓰지	nqpc
가쓰히코	nqpc
가압류	ncn
가애자	nqq
가야	nqq
가야건축	ncpa
가야금	ncn
가야리	ncn
가야문화	ncn
가야사	ncn
가야사회	ncn
가야산	nqq
가야시대	ncn
가야제국	ncn
가야지방	ncn
가야하	pvg
가양지구	nqq
가양지구근로자임대아파트	nqq
가양희	nqpc
가어	nqq
가언	ncn
가업	ncn
가업계승	ncn
가없이	mag
가역성	ncn
가연성	ncn
가연순	nqpc
가열	ncn	ncpa	ncps
가열국면	ncn
가열로	ncn
가열방식	ncn
가열전류	ncn
가열조리	ncn
가열조리기	ncn
가열조짐	ncn
가엽	paa.irrb
가엾	paa
가영수증	ncn
가영순	nqpc
가영택	nqpc
가영현	nqpc
가예	ncn
가오디	nqpc
가오루	ncn
가오리	ncn
가오리연	ncn
가오즈	nqpc
가옥	ncn
가옥구조	ncn
가옥순	nqpc
가옥자	nqpc
가온	ncn
가와니시	nqq
가와니시공업	nqq
가와마타	nqpc
가와마타겐지로	nqpc
가와무라	nqpc
가와무라다케오	nqpc
가와바타	nqpc
가와바타다쓰오	nqpc
가와바타야스나리	nqpc
가와사키	ncn
가와사키시	ncn
가와사키연구소	nqq
가와사키중공업	nqq
가와시마	nqpc
가와시마미노루	nqpc
가요	ncn
가요계	ncn
가요곡	ncn
가요관계자	ncn
가요레코드	ncn
가요방	ncn
가요사상	ncn
가요순위프로그램	ncn
가요시장	ncn
가요음반	ncn
가요음반계	ncn
가요음반시장	ncn
가요음반업계	ncn
가요일반	ncn
가요제	ncn
가요주점	ncn
가요프로	ncn
가요학원	ncn
가용	ncn
가용수단	ncn
가용식량	ncn
가용인력수급	ncpa
가용자원	ncn
가용재원	ncn
가용전력	ncn
가용지역	ncn
가용진	nqpc
가용층	ncn
가용현	nqpc
가우디	nqq
가우모양	ncn
가우스	nqq
가운	ncn
가운노	nqpc
가운데	ncn
가운뎃다리	ncn
가운섭	nqpc
가위	ncn
가위꼴	ncn
가위눌리	pvg
가위바위보	ncn
가위질	ncpa
가위집	ncn
가위집게	ncn
가윗밥	ncn
가유현	nqpc
가육현	nqpc
가을	ncn
가을갈이	ncpa
가을개편	ncpa
가을걷이	ncpa
가을경	ncn
가을구름	ncn
가을꽃	ncn
가을나비	ncn
가을날	ncn
가을날씨	ncn
가을바겐세일	ncpa
가을바람	ncn
가을배추	ncn
가을안	ncn
가을양배추	ncn
가을여행	ncpa
가을철	ncn
가을철바겐세일	ncpa
가을패션	ncn
가을풍경	ncn
가을피부	ncn
가을학기	ncn
가이	ncn
가이다르	nqpc
가이달	nqpc
가이드	ncpa
가이드라인	ncn
가이드북	ncn
가이스코	nqq
가이아나	nqq
가이우스	nqpc
가이우스율리우스	nqpc
가이우스율리우스시저	nqpc
가이우스율리우스케사르	nqpc
가이후	nqpc
가이후도시키	nqpc
가인	ncn	nqq
가인가	ncpa
가인괘	ncn
가인숙	nqpc
가인시스템	nqq
가인시스템연구소	nqq
가인시스팀	nqq
가인식성	ncn
가인지	nqpc
가일층	mag	ncn
가일현	nqpc
가입	ncpa
가입결정권	ncn
가입국	ncn
가입금액	ncn
가입기간	ncn
가입단말기	ncn
가입대상	ncn
가입명수	ncn
가입문제	ncn
가입방법	ncn
가입번호	ncn
가입분	ncn
가입비	ncn
가입비구조	ncn
가입사실	ncn
가입신청	ncpa
가입신청서	ncn
가입실적	ncn
가입업체	ncn
가입여부	ncn
가입자	ncn
가입자격	ncn
가입자관리시스팀	ncn
가입자구내	ncn
가입자번호	ncn
가입자선정	ncpa
가입자수	ncn
가입자장비	ncn
가입자증가추세	ncn
가입자회선	ncn
가입전망	ncn
가입전화	ncpa
가입전화시설	ncn
가입조건	ncn
가입종목	ncn
가입지원	ncpa
가입차량	ncn
가입청약자	ncn
가입한도	ncn
가입협상	ncpa
가입회원	ncn
가자	nqq
가자미	ncn
가자미근	ncn
가자시	nqq
가자시티	nqq
가자지구	ncn
가작	ncn
가장	mag	ncn	ncpa
가장격	ncn
가장교	ncn
가장권	ncn
가장기물	ncn
가장완전	ncps
가장자리	ncn
가장자리선	ncn
가장지리	ncn
가장티	ncn
가장행렬	ncn
가장현	nqpc
가재	ncn
가재길	nqpc
가재도구	ncn
가재두	nqpc
가재민	nqpc
가재영	nqpc
가재완	nqpc
가재왕	nqpc
가재용	nqpc
가재우	nqpc
가재율	nqpc
가재의	nqpc
가재창	nqpc
가재하	nqpc
가전	ncn
가전3사	ncn
가전계열사	ncn
가전공장	ncn
가전기기	ncn
가전대리점	ncn
가전대리점관계자	ncn
가전대리점망	ncn
가전대리점업자	ncn
가전대리점이벤트행사	ncpa
가전대일수출	ncpa
가전메이커	ncn
가전본부	ncn
가전부문	ncn
가전부서	ncn
가전분야	ncn
가전사	ncn
가전사업부	ncn
가전산업	ncn
가전서비스센터	ncn
가전시장	ncn
가전양판점	ncn
가전업계	ncn
가전업계측	ncn
가전업체	ncn
가전연구실	ncn
가전영업망	ncn
가전용	ncn
가전유통망	ncn
가전유통시장	ncn
가전유통체계	ncn
가전전문양판점	ncn
가전점	ncn
가전제품	ncn
가전제품경연장	ncn
가전제품관련	ncpa
가전제품관련기술	ncn
가전제품서비스우대행사	ncpa
가전제품수출	ncpa
가전제품시장	ncn
가전제품신기술	ncn
가전제품양판점	ncn
가전제품원매자	ncn
가전제품회사	ncn
가전종합메이커	ncn
가전종합연구소설립	ncpa
가전채널	ncn
가전품	ncn
가전품수요	ncn
가전품수출	ncpa
가전화	ncpa
가전회사	ncn
가정	ncn	ncpa
가정간	ncn
가정경제	ncn
가정과	ncn
가정관리	ncpa
가정교사	ncn
가정교육	ncpa
가정국토	ncn
가정근무	ncn
가정근무제	ncn
가정기기	ncn
가정내폭력	ncn
가정대	ncn
가정대학	ncn
가정도	ncn
가정도덕	ncn
가정동	nqq
가정드라마	ncn
가정란	ncn
가정로	nqpc
가정만화	ncn
가정문제	ncn
가정배달	ncn
가정백과사전	ncn
가정법률	ncn
가정법률상담소	nqq
가정법원	nqq
가정복지	ncn
가정복지계장	ncn
가정부	ncn
가정부담	ncpa
가정부업	ncn
가정분위기	ncn
가정불화	ncn
가정사정	ncn
가정상	ncn
가정생활	ncpa
가정생활용품	ncn
가정생활용품대전	ncn
가정생활용품대처분전	ncn
가정성원	ncn
가정소설	ncn
가정순	nqpc
가정영화	ncn
가정예배	ncn
가정용게임기	ncn
가정용기기	ncn
가정용기기부문	ncn
가정용기기분야	ncn
가정용기기업계	ncn
가정용기름보일러	ncn
가정용보일러	ncn
가정용분야	ncn
가정용비디오게임	ncn
가정용비디오게임기	ncn
가정용시대	ncn
가정용시장	ncn
가정용전자	ncn
가정용전자부문	ncn
가정용전자업체	ncn
가정용전화기	ncn
가정용정수기	ncn
가정용제품	ncn
가정용팩시밀리	ncn
가정용퍼스컴	ncn
가정용퍼스컴분야	ncn
가정용퍼스컴시장	ncn
가정용품	ncn
가정용품매장	ncn
가정용품임대업	ncn
가정운영	ncpa
가정원예	ncn
가정위탁보호제도	ncn
가정의	ncn
가정의례	ncn
가정의례제도	ncn
가정의례준칙	ncn
가정의학	ncn
가정이념	ncn
가정자동화	ncn	ncpa
가정전기제품	ncn
가정정보시스팀	ncn
가정제도	ncn
가정주부	ncn
가정질서	ncn
가정집	ncn
가정천국	ncn
가정체제	ncn
가정친화	ncn	ncpa
가정탁아시설	ncn
가정파괴	ncn	ncpa
가정파괴범	ncn
가정파탄	ncpa
가정폭력	ncn
가정학과	ncn
가정형편	ncn
가정화목	ncn
가정환경	ncn
가제	ncn
가제로	nqpc
가제본	ncpa
가제코가즈요시	nqpc
가제트	nqq
가져가	pvg
가져다주	pvg
가져오	pvg
가족	ncn
가족간	ncn
가족갈등	ncpa
가족경험	ncn
가족경호인력	ncn
가족계승	ncpa
가족계획	ncpa
가족공간	ncn
가족공동체	ncn
가족공원	ncn
가족공원묘지	ncn
가족관계	ncn
가족관념	ncpa
가족관련단체연합	ncn	ncpa
가족구성	ncpa
가족구성원	ncn
가족구조	ncn
가족규모	ncn
가족극장	ncn
가족기능	ncn
가족기업	ncpa
가족나들이	ncn	ncpa
가족놀이	ncn
가족농장	ncn
가족단위	ncn
가족동반	ncpa
가족동의	ncn
가족명의	ncn
가족모두	ncn
가족묘원	ncn
가족묘지	ncn
가족문제	ncn
가족법	ncn
가족법개정	ncpa
가족법개정제지	ncn
가족부양	ncpa
가족사	ncn
가족사업	ncn
가족사이	ncn
가족사진	ncn
가족사항	ncn
가족사회	ncn
가족살해	ncpa
가족상봉	ncpa
가족상황	ncn
가족생활	ncpa
가족성원	ncn
가족소개	ncpa
가족수당	ncn
가족수당지급	ncpa
가족수입	ncpa
가족시간대	ncn
가족시청시간	ncn
가족시청시간대	ncn
가족신문	ncn
가족싸움	ncpa
가족애	ncn
가족여행	ncpa
가족연구	ncpa
가족영화	ncn
가족예산	ncpa
가족오락물	ncn
가족운동협의회	nqq
가족원	ncn
가족유형	ncn
가족의식	ncn
가족이기주의	ncn
가족이념	ncn
가족이론	ncn
가족이름	ncn
가족인원수	ncn
가족전체	ncn
가족제도	ncn
가족조직	ncn
가족주의	ncn
가족중심	ncn
가족질서	ncn
가족집단	ncn
가족체계	ncn
가족친지	ncn
가족패션	ncn
가족학자	ncn
가족형태	ncn
가족호스피스	ncn
가족호텔	ncn
가족회사	ncn
가족회식	ncn	ncpa
가족회원	ncn
가족회의	ncpa
가종린	nqpc
가주	ncn
가주대학	ncn
가주현	nqpc
가죽	ncn
가죽구두	ncn
가죽끈	ncn
가죽나무	ncn
가죽동이	ncn
가죽밴드	ncn
가죽부대	ncn
가죽소파	ncn
가죽시트	ncn
가죽신	ncn
가죽옷	ncn
가죽의류	ncn
가죽잠바	ncn
가죽장갑	ncn
가죽장화	ncn
가죽제품업	ncn
가죽주머니	ncn
가중	ncpa
가중처벌	ncpa
가중치	ncn
가중평균	ncn
가즈미	ncn
가즈오	nqq
가즈요	nqpc
가즈요시	nqpc
가증	ncps
가지	nbu	ncn	pvg
가지가지	mag	ncn
가지각색	ncn
가지계명	ncn
가지고서	ncn
가지나무	ncn
가지런	ncps
가지런히	mag
가지산문	ncn
가지산사	ncn
가지색	ncn
가지수	ncn
가지야마	ncn
가지야마세이로쿠	nqpc
가지연구	ncpa
가지인가	ncpa
가지적	ncn
가지접붙이기	ncn
가지지구	nqq
가지채비	ncpa
가지체계	ncn
가지치	pvg
가지치기	ncn
가지현	nqpc
가지현상	ncn
가직현	nqpc
가진숙	nqpc
가짐	ncn
가짓수	ncn
가짜	ncn
가짜그림	ncn
가짜명박사건	ncn
가짜박사	ncn
가짜박사학위	ncn
가짜상품	ncn
가짜손님	ncn
가짜수염	ncn
가짜신호	ncn
가짜예술	ncn
가짜학위	ncn
가차없	paa
가차없이	mag
가찰포교	ncpa
가창	ncpa
가창국	nqpc
가창력	ncn
가채	ncn
가책	ncpa
가처분	ncn
가처분소득	ncn
가처분신청	ncn
가처분신청쟁송	ncpa
가천공장	nqq
가철순	nqpc
가촛돌	ncn
가축	ncn
가축경제	ncn
가축기르	pvg.irrlu
가축병원	ncn
가축사료	ncn
가축사업자	ncn
가축사육	ncpa
가축위생	ncn
가축위생시험연구소	ncn
가축전염병	ncn
가춘왕	nqpc
가춘호	nqpc
가출	ncpa
가출소년	ncn
가출옥	ncpa
가출자	ncn
가출하	ncpa
가치	ncn
가치감각	ncn
가치개념	ncn
가치결정	ncn
가치고찰	ncpa
가치공학	ncn
가치관	ncn
가치관계	ncn
가치관념	ncpa
가치관련성	ncn
가치관부재	ncpa
가치구성	ncpa
가치구조	ncn
가치구현	ncpa
가치규범	ncn
가치기준	ncn
가치논쟁	ncpa
가치론	ncn
가치맹목	ncn
가치문제	ncn
가치물	ncn
가치물음	ncn
가치발견	ncpa
가치범주	ncn
가치법칙	ncn
가치법칙논쟁	ncn
가치법칙론	ncn
가치변모	ncpa
가치변형	ncpa
가치변화	ncpa
가치변환	ncpa
가치부분	ncn
가치부여	ncpa
가치불변	ncpa
가치사상	ncn
가치생산물	ncn
가치성	ncn
가치성격	ncn
가치세계	ncn
가치소멸	ncpa
가치시스템	ncn
가치실현	ncpa
가치실현과정	ncpa
가치언어	ncn
가치원리	ncn
가치위상	ncn
가치유산	ncn
가치의식	ncn
가치이념	ncn
가치이론	ncn
가치인식	ncpa
가치자체	ncn
가치잠식	ncpa
가치장검	ncn
가치저장	ncpa
가치저장기능	ncn
가치저장수단	ncn
가치저하	ncpa
가치저화	ncn
가치적정	ncpa
가치전도	ncpa
가치전복	ncn
가치전환	ncpa
가치제시	ncpa
가치제품	ncn
가치중립	ncpa
가치중심	ncn
가치증식	ncpa
가치증식과정	ncpa
가치증식조건	ncn
가치지향	ncpa
가치지향점	ncn
가치진술	ncpa
가치차별	ncpa
가치차원	ncn
가치창조	ncpa
가치창출	ncpa
가치척도	ncn
가치체계	ncn
가치체제	ncn
가치총량불변	ncpa
가치측정	ncpa
가치측정매개	ncpa
가치크기	ncn
가치파괴	ncpa
가치판단	ncpa
가치평가	ncpa
가치포함	ncpa
가치표장	ncn
가치표현	ncpa
가치하락	ncpa
가치합계	ncpa
가치합리	ncn
가치합리성	ncn
가치허무주의	ncn
가치혁신	ncn
가치형가	ncn
가치형성	ncpa
가치형태	ncn
가치혼돈	ncpa
가치혼란	ncps
가치확립	ncpa
가치회복	ncpa
가칭	ncpa
가쿠사브로	ncn
가쿠에이	nqq
가키자와	nqpc
가키자와고지	nqpc
가타리	nqq
가타야마	nqpc
가타야마도라노스케	nqpc
가타오카	nqpc
가타오카다케시	nqpc
가탕	ncn
가택	ncn
가택수색	ncpa
가택연금	ncn
가택현	nqpc
가토	ncn
가토고이치	nqpc
가토우고우이치	nqpc
가톨리시즘	ncn
가톨릭	ncn
가톨릭교	ncn
가톨릭교도	ncn
가톨릭교회	ncn
가톨릭농민회	nqq
가톨릭단체	ncn
가톨릭대	nqq
가톨릭대학	nqq
가톨릭대학부속강남성모병원	nqq
가톨릭대학부속성모병원	nqq
가톨릭시국대책위원회	ncn
가톨릭신부출신	ncn
가톨릭신자	ncn
가톨릭실업인회	ncn
가톨릭의대	nqq
가톨릭의대강남성모병원	nqq
가톨릭의대성모병원	nqq
가톨릭의식	ncn
가톨릭정책	ncn
가톨릭회관	ncn
가통	ncn
가투	ncn
가트	nqq
가트가입	ncpa
가트규정	ncpa
가트너그룹	nqq
가트체제	ncn
가트협상	ncn
가트회원국	ncn
가파르	paa
가파르나움	nqq
가판	ncpa
가판점	ncn
가평	nqq
가평군	nqq
가폭제	ncn
가폰	nqq
가폰신부	ncn
가풀막	ncn
가풍	ncn
가프이가왕직메	nqpc
가피	ncpa
가피력	ncn
가필	ncpa
가하	paa	pvg
가하여지	pvg
가학	ncpa
가학성	ncn
가함	ncn
가해	ncpa
가해자	ncn
가해지	pvg
가해책임자	ncn
가현	nqpb
가협정	ncpa
가형로	nqpc
가호	nbu	ncn	ncpa
가혹	ncps
가혹행위	ncpa
가화	ncn
가화합	ncpa
가환	ncn
가회동	nqq
가훈	ncn
가히	mag
각	mma	ncn
각가지	ncn
각각	mag	ncn
각각으로	mag
각개격파	ncn
각개격파식	ncn
각개약진	ncpa
각개인	ncn
각계	ncn
각계각층	ncn
각계급관계사	ncn
각계기	ncn
각계대표	ncpa
각계원로	ncn
각계인사	ncn
각고	ncpa
각고노력	ncpa
각광	ncn	ncpa
각국	ncn
각국간	ncn
각국교회협의회	ncn
각국대사	ncn
각국대표	ncpa
각국별	ncn
각국선수	ncn
각국어	ncn
각국업체	ncn
각국인	ncn
각국자료	ncn
각국정부	ncn
각국정상	ncn
각국화폐	ncn
각군	ncn
각궁	ncn
각권	ncn
각균	ncn
각급	ncn
각급건축	ncpa
각급학교	ncn
각급학교간	ncn
각기	mag	ncn
각기병	ncn
각기업	ncn
각나라	ncn
각다분	ncps
각단계	ncn
각대	ncn
각대학	ncn
각도	ncn
각도기	ncn
각도시	ncn
각도유생	ncn
각돔형	ncn
각론	ncn
각료	ncn
각료급인사	ncn
각료이사회	ncn
각료인선	ncn
각료임명	ncn
각료회담	ncpa
각료회의	ncpa
각료회의때	ncn
각막	ncn
각막염	ncn
각막이식	ncn
각막절삭법	ncn
각메이커	ncn
각목	ncn
각목폭행	ncpa
각박	ncn	ncps
각방	ncn
각별	ncps
각별히	mag
각본	ncn
각본가	ncn
각본상	ncn
각본수사	ncpa
각부	ncn
각부문	ncn
각부분	ncn
각부위원	ncn
각부처	ncn
각분야	ncn
각분야별	ncn
각사별	ncn
각사업부	ncn
각삼랑	ncn
각색	ncn	ncpa
각서	ncn
각서이행	ncpa
각설	maj	ncpa
각설탕	ncn
각설하고	maj
각성	ncn	ncpa
각성상태	ncn
각성운동	ncpa
각성제	ncn
각수	nqpb
각순	nqpb
각시	ncn
각시광대	ncn
각시기별	ncn
각시도교육위원회	ncn
각심사	ncn
각양	ncn
각양각색	ncn
각양각종	ncn
각업체	ncn
각연구실	ncn
각영역	ncn
각오	ncpa
각위	ncn
각은행	ncn
각응용부문	ncn
각의	ncn
각의의결	ncn
각이	ncps
각인	ncn	ncpa
각자	mag	ncn
각재	ncn
각조	ncn
각종	ncn
각종건축물	ncn
각종교	ncn
각종규격연구	ncpa
각종규제	ncpa
각종기기	ncn
각종대회	ncn
각종데이터	ncn
각종데크수급	ncpa
각종디자인개발	ncpa
각종모터	ncn
각종문화행사	ncpa
각종박람회	ncn
각종배당금	ncn
각종사고예방대책	ncn
각종서체	ncn
각종설비	ncpa
각종세라믹부품	ncn
각종시설	ncn
각종여론조사	ncn
각종오염	ncpa
각종요인	ncn
각종육성시책	ncn
각종전자장치	ncn
각종정보	ncn
각종제품	ncn
각종주변기기	ncn
각종통신상황	ncn
각종프로그램	ncn
각종학교	ncn
각종할인혜택	ncn
각주	ncn
각지	ncn
각지방공장	ncn
각지역	ncn
각진	ncn
각처	ncn
각축	ncpa
각축장	ncn
각축전	ncn
각층	ncn
각카드사	ncn
각파	ncn
각하	ncpa	ncr
각현	nqpb
각혈	ncn
각형	ncn
각호	ncn
각화동	ncn
각황전	nqq
각효	ncn
간	nbn	ncn	nqpa	xsna	xsncc	xsnu
간간	mag	ncps
간간이	mag
간간히	mag
간격	ncn
간결	ncn	ncps
간결성	ncn
간결히	mag
간경변증	ncn
간경화	ncn
간계	ncn	ncpa
간고	ncps
간고분투	ncn
간곡	ncps
간곡히	mag
간공	nqq
간과	ncpa
간교	ncps	nqq
간구	ncpa
간극	ncn
간기	ncn
간기능	ncn
간길	nqq
간나이	nqq
간난	nqpb
간녕	ncps
간뇌	ncn
간다라	nqq
간다라어	ncn
간단	ncps
간단명료	ncn	ncps
간단없이	mag
간단히	mag
간담	ncn	ncpa
간담회	ncn
간댕간댕	mag
간덩이	ncn
간도	ncn	nqq
간도성	nqq
간도지방	ncn
간들간들	mag
간디	nqq
간디가문	ncn
간디스토마	ncn
간디집안	ncn
간략	ncps
간략화	ncpa
간략히	mag
간막이	ncn
간만	ncn
간만차	ncn
간명	ncps
간발	ncn
간밤	ncn
간병	ncn
간병비	ncn
간보	ncn	pvg
간부	ncn
간부급	ncn
간부사원	ncn
간부시절	ncn
간부양성코스	ncn
간부직원	ncn
간부학교	ncn
간부회	ncn
간부회의	ncn
간빙기	ncn
간사	ncr
간사위원	ncn
간사장	ncr
간사함	ncn
간서	ncn
간석	ncn
간석지	ncn
간선	ncpa
간선도로	ncn
간선도로망	ncn
간섭	ncpa
간섭값	ncn
간섭문서	ncn
간섭문제	ncn
간섭주의	ncn
간섭현상	ncn
간성	ncn
간세포	ncn
간소	ncps
간소화	ncpa
간송미술관	ncn
간수	ncn	ncpa
간수병	ncn
간수장	ncr
간승현	nqpc
간식	ncn	ncpa
간식거리	ncn
간식비	ncn
간신	ncn
간신명	nqpc
간신배	ncn
간신히	mag
간아내리	pvg
간악	ncps
간암	ncn
간언	ncpa
간여	ncpa
간여행위	ncpa
간염	ncn
간염바이러스	ncn
간염백신	ncn
간염예방	ncn
간염치료제	ncn
간염퇴치	ncn
간염환자	ncn
간영미	nqpc
간영숙	nqpc
간원택	nqpc
간유	ncn
간유리	ncn
간유리판	ncn
간음	ncn	ncpa
간음죄	ncn
간이	ncn
간이과세	ncpa
간이과세제도	ncn
간이매점	ncn
간이무선국	ncn
간이무전기	ncn
간이방	ncn
간이세율	ncn
간이소각	ncpa
간이식당	ncn
간이염	ncn
간이용	ncn
간이우체국	ncn
간이입력장치	ncn
간이자동화	ncpa
간이자동화분야	ncn
간이주택	ncn
간이주행로	ncn
간이집수조	ncn
간이침대	ncn
간이침상	ncn
간이형	ncn
간인터페이스분야	ncn
간자키	nqpc
간자키다케노리	nqpc
간잔지런	ncps
간장	ncn
간장관계	ncn
간장독	ncn
간장병	ncn
간장보호작용	ncpa
간장이식	ncn
간장종지	ncn
간장질환	ncn
간적	nqq
간절	ncps
간절히	mag
간접	ncn
간접경로	ncn
간접경비	ncn
간접경비절감	ncpa
간접경험	ncpa
간접광	ncn
간접교역	ncpa
간접교환	ncn
간접금융	ncn
간접금융시장	ncn
간접냉각방식	ncn
간접당사자	ncn
간접무늬	ncn
간접무역	ncn
간접민주제	ncn
간접민주주의	ncn
간접부문	ncn
간접비용	ncn
간접비용절감책	ncn
간접비판	ncpa
간접선거	ncpa
간접선교	ncpa
간접성	ncn
간접세	ncn
간접수입	ncn
간접수출	ncn
간접시설	ncn
간접시인	ncn
간접신용조사	ncpa
간접연구경비	ncpa
간접영향권	ncn
간접요인	ncn
간접의료	ncn
간접의료비	ncn
간접의료비용	ncn
간접인력	ncn
간접자본	ncn
간접자본시설	ncn
간접조명	ncpa
간접증명	ncpa
간접지원	ncpa
간접참여	ncpa
간접체험	ncpa
간접취재	ncpa
간접침투	ncpa
간접통치	ncpa
간접투표	ncn
간접판매	ncpa
간접판매방식	ncn
간접판매영업	ncpa
간접풍자	ncpa
간접화행	ncpa
간정희	nqpc
간조	ncn
간조기	ncn
간종택	nqpc
간주	ncn	ncpa
간주곡	ncn
간주리	ncn
간증	ncpa
간지	ncn	ncpa
간지럽히	pvg
간직	ncpa
간질	ncn
간질간질	mag
간질병	ncn
간질은	ncn
간질이	pvg
간질환	ncn
간질환자	ncn
간짓대	ncn
간척	ncn
간척개발사업	ncn
간척공사	ncpa
간척사업	ncn
간척사업대상	ncn
간척지	ncn
간척지매립	ncn
간첩	ncn
간첩공작지령	ncpa
간첩교육	ncpa
간첩단사건	ncn
간첩단사건내용	ncn
간첩단설	ncn
간첩사건	ncn
간첩신세	ncn
간첩조작사건	ncn
간첩죄	ncn
간첩활동	ncpa
간청	ncpa
간촉	ncpa
간추리	pvg
간취	ncpa
간택	ncpa
간토특수제강	nqq
간통	ncpa
간통죄	ncn
간통죄폐지	ncn
간통죄폐지논란	ncn
간통행위	ncpa
간파	ncpa
간판	ncn
간판격	ncn
간판경영	ncpa
간판메뉴	ncn
간판상품	ncn
간판선수	ncn
간판스타	ncn
간판시스템	ncn
간판연기자	ncn
간판주자	ncn
간편	ncn	ncps
간편복	ncn
간편해지	pvg
간편화	ncpa
간평리	ncn
간행	ncn	ncpa
간행물	ncn
간행물윤리위원회	nqq
간행위원	ncn
간행위원회	ncn
간행위원회편	ncn
간헐	ncpa
간헐적	ncn
간호	ncpa
간호과장	ncn
간호대	ncn
간호법	ncn
간호병	ncn
간호부	ncn
간호사	ncn
간호연	nqpc
간호원	ncr
간호조무사	ncn
간호진	nqpc
간호체계	ncn
간호학	ncn
간호학과	ncn
간호학원	ncn
간혹	mag
갇히	pvg
갈	ncn	nqpa	pvg
갈가리	mag
갈가마귀	ncn
갈고닦	pvg
갈고랑이	ncn
갈고리	ncn
갈구	ncpa
갈구리	ncn
갈급	ncps
갈기	ncn	pvg
갈기갈기	mag
갈기머리	ncn
갈기발기	mag
갈길	ncn
갈꽃	ncn
갈내	nqq
갈대	ncn
갈대껍질	ncn
갈대밭	ncn
갈대아	nqq
갈대아인	ncn
갈대이삭	ncn
갈대잎	ncn
갈데아인	ncn
갈데없	paa
갈도소리	ncn
갈등	ncpa
갈등관계	ncn
갈등관리	ncpa
갈등구조	ncn
갈등문제	ncn
갈등부재	ncpa
갈등상태	ncn
갈등양상	ncn
갈등요소	ncn
갈등요인	ncn
갈등의식	ncn
갈등전선	ncn
갈등지역	ncn
갈등처리요령	ncn
갈등축소	ncpa
갈등해결	ncpa
갈등해소	ncpa
갈등현상	ncn
갈라내	pvg
갈라디아서	nqq
갈라맡	pvg
갈라먹기식	ncn
갈라서	pvg
갈라지	pvg
갈라지기	ncn
갈라짐	ncn
갈래	ncn
갈래길	ncn
갈래머리	ncn
갈레데	nqq
갈로	nqq
갈루피	nqq
갈리	nqq	pvg
갈리나	nqpc
갈리나파블로브나	nqpc
갈리나파블로브나비슈네프스카야	nqpc
갈리나파블로브나비시네프스카야	nqpc
갈리레이	nqq
갈리리	nqq
갈리마르	ncn
갈리시아	nqq
갈리시아어	ncn
갈릴래아	nqq
갈릴레아	nqq
갈릴레오	nqq
갈릴레이	nqq
갈릴리바다	nqq
갈릴리호수	nqq
갈림길	ncn
갈마리	ncn
갈마보	pvg
갈망	ncpa
갈망상태	ncn
갈매기	ncn
갈매나무	ncn
갈멜	nqq
갈무리	ncpa
갈방아	ncn
갈보	ncn
갈봉근	ncn
갈봉호	nqpc
갈브레이드	nqpc
갈비	ncn
갈비뼈	ncn
갈빈	nqpc
갈산	ncn
갈새	ncn
갈색	ncn
갈색눈	ncn
갈색머리	ncn
갈색반점	ncn
갈수	ncn
갈수록	mag
갈수상태	ncn
갈순애	nqpc
갈순이	nqpc
갈숲	ncn
갈아입	pvg
갈아타	pvg
갈애	ncpa
갈양자	nqpc
갈영길	nqpc
갈영복	nqpc
갈옥철	nqpc
갈원돈	nqpc
갈원선	nqpc
갈을근	nqpc
갈음하	pvg
갈이	ncn
갈익성	nqpc
갈재	nqq
갈정숙	nqpc
갈조	ncn
갈종선	nqpc
갈종성	nqpc
갈종진	nqpc
갈증	ncn
갈지자형	ncn
갈창영	nqpc
갈창훈	nqpc
갈채	ncpa
갈취	ncpa
갈치	ncn
갈쿠리	ncn
갈탄	ncn
갈파	ncpa
갈팡질팡	mag
갈팡질팡하	pvg
갈포	ncn
갈피	ncn
갈피갈피	mag	ncn
갈하	paa
갈한덕	nqpc
갈현	ncn
갈현동	ncn
갈현찬	nqpc
갈홍	nqq
갈희경	nqpc
갈희철	nqpc
갉아먹	pvg
감	nbn	ncn	nqpa	pvg
감가	ncn
감가상각	ncn
감가상각면	ncn
감가상각비명목	ncn
감각	ncpa
감각경로	ncn
감각경험	ncpa
감각기관	ncn
감각기능	ncn
감각마비	ncpa
감각반응	ncpa
감각상각비	ncn
감각성	ncn
감각세계	ncn
감각세포	ncn
감각소여	ncn
감각신경	ncn
감각인상	ncn
감각인식	ncpa
감각자극	ncpa
감각작용	ncpa
감각정보	ncn
감각주의	ncn
감각주조	ncn
감각주조론	ncn
감각체계	ncn
감각통로	ncn
감각특성	ncn
감감	ncps
감감무소식	ncn
감개	ncpa
감개무량	ncpa
감격	ncpa	ncps
감경	ncpa
감경자	nqpc
감고	ncn	ncpa
감골	nqq
감관	ncn
감광	ncpa
감광도	ncn
감광수지	ncn
감군제의	ncn
감귤	ncn
감귤나무	ncn
감귤류	ncn
감귤생산지	ncn
감귤차	ncn
감금	ncpa
감금생활	ncpa
감금실	ncn
감금제도	ncn
감금체제	ncn
감기	ncn	pvg
감기기운	ncn
감기기침	ncpa
감기들리	pvg
감기술	nqpc
감기약	ncn
감기예방	ncpa
감기증상	ncn
감기증세	ncn
감기호	nqpc
감기환자	ncn
감길천	nqpc
감나무	ncn
감나무마을	ncn
감나무집	ncn
감나뭇골	nqq
감내	ncpa
감당	ncpa
감도	ncn
감독	ncpa
감독강화	ncn
감독과정	ncpa
감독관	ncr
감독관청	ncn
감독교사	ncpa
감독교체	ncpa
감독권	ncn
감독기관	ncn
감독기관격	ncn
감독기능	ncn
감독대우	ncn
감독대행	ncn	ncpa
감독목숨	ncn
감독발령	ncpa
감독상	ncn
감독생활	ncn	ncpa
감독선	ncn
감독선생님	ncn
감독소홀	ncps
감독원	ncr
감독이사회	ncn
감독자	ncn
감독제도	ncn
감독주간	ncn
감독직	ncn
감독직제	ncn
감독직제의	ncn
감독체계	ncn
감독하	ncn
감독행위	ncpa
감독행정	ncn
감돌	pvg
감동	ncpa	ncps
감동헌	nqpc
감두남	nqpc
감득	ncpa
감람나무	ncn
감람유	ncn
감래우	nqpc
감량	ncpa
감량경영	ncpa
감량경영체제	ncn
감로	ncn
감리	ncpa	nqq
감리과정	ncn	ncpa
감리교	ncn
감리대상종목	ncn
감리업체	ncn
감리역	ncn
감리자	ncn
감리제도	ncn
감리종목	ncn
감리풍토	ncn
감리회	nqq
감마선	ncn
감면	ncpa
감면규제	ncn
감면제도	ncn
감면조치	ncn
감면혜택	ncn
감명	ncpa
감명깊	paa
감명돈	nqpc
감명복	nqpc
감명수	nqpc
감명식	nqpc
감미	ncn	ncpa	ncps
감미료	ncn
감민호	nqpc
감바쿠도노	ncn
감바쿠도노의	ncn
감발	ncpa
감방	ncn
감방생활	ncpa
감별	ncpa
감병구	nqpc
감병기	ncn
감복	ncpa
감봉	ncn
감봉조	nqpc
감비아	nqq
감비아공화국	nqq
감사	ncpa	ncr
감사가	ncn
감사결과	ncn
감사결과보고	ncn
감사관	ncr
감사관실	ncn
감사권	ncn
감사기관	ncn
감사기구	ncn
감사기도	ncn
감사담당관	ncn
감사대상	ncn
감사드리	pvg
감사료	ncn
감사방법	ncn
감사방향	ncn
감사보고	ncn
감사보고서	ncn
감사부문	ncn
감사비리	ncn
감사석	ncn
감사실검사역	ncn
감사실장	ncn
감사업무	ncn
감사원	ncn	nqq
감사원장	ncr
감사위원회	nqq
감사인	ncn
감사자료	ncn
감사장	ncn
감사절	ncn
감사제	ncn
감사제도	ncn
감사중복방지	ncpa
감사카드	ncn
감사팀	ncn
감사패	ncn
감사편지	ncpa
감사활동	ncpa
감사후르디아	nqpc
감산	ncpa
감산풀이	ncn
감상	ncn	ncpa
감상가	ncn
감상기회	ncn
감상담	ncn
감상력	ncn
감상문	ncn
감상법	ncn
감상분과	ncn
감상비평	ncpa
감상성	ncn
감상순서	ncn
감상실	ncn
감상욕구	ncn
감상우의	ncn
감상자	ncn
감상주의	ncn
감상태도	ncn
감상호	nqq
감상회	ncn
감색	ncn	ncpa
감선식	nqpc
감선자	nqpc
감성	ncn
감성공학	ncn
감성공학연구	ncpa
감성공학프로젝트	ncn
감성론	ncn
감성철	nqpc
감세	ncn
감세민소	ncn
감세정책	ncn
감소	ncpa
감소세	ncn
감소율	ncn
감소추세	ncn
감소함수	ncn
감소현상	ncn
감소효과	ncn
감속기생산	ncpa
감수	ncn	ncpa
감수분열	ncn	ncpa
감수성	ncn
감수자	ncn
감수작용	ncpa
감숙	nqq
감숙방면	ncn
감승	nqq
감승림	nqpc
감시	ncpa
감시가격제도	ncn
감시기구	ncn
감시기능	ncn
감시기록	ncpa
감시기술	ncn
감시눈초리	ncn
감시대	ncn
감시대상	ncn
감시등	ncn
감시로	ncn
감시망	ncn
감시병	ncn
감시센터	ncn
감시소	ncn
감시소홀	ncps
감시요원	ncn
감시용카메라업계	ncn
감시원	ncr
감시위원회	ncn
감시자	ncn
감시장비	ncn
감시장치	ncn
감시절차	ncn
감시조직	ncpa
감시체계	ncn
감시체제	ncn
감시초소	ncn
감시카메라	ncn
감시태세	ncn
감시활동	ncn	ncpa
감식	ncpa
감싸	pvg
감싸이	pvg
감안	ncpa
감액	ncpa
감언이설	ncn
감연규	nqpc
감염	ncpa
감염경로	ncn
감염경험	ncpa
감염률	ncn
감염물질	ncn
감염자	ncn
감영	ncn
감영군	ncn
감옥	ncn
감옥개선운동	ncpa
감옥살이	ncpa
감옥생활	ncpa
감옥소	ncn
감옥영화	ncn
감옥제도	ncn
감옥체제	ncn
감옥행정	ncn
감완근	nqpc
감용	nqpb
감우근	nqpc
감원	ncn
감원계획	ncpa
감원바람	ncn
감원선풍	ncn
감원시	ncn
감원이	nqpc
감원조치	ncpa
감은	ncpa
감은사	nqq
감음작용	ncpa
감응	ncpa
감응방식	ncn
감응상태	ncn
감응이론	ncn
감임이	nqpc
감잎	ncn
감자	ncn
감자가루	ncn
감자국	ncn
감자껍질	ncn
감자녹말	ncn
감자맛	ncn
감자바위	ncn
감자밭	ncn
감자범벅	ncn
감자부각	ncpa
감자부침	ncn
감자산업	ncn
감자송편	ncn
감자수프	ncn
감자스낵자판기	ncn
감자알	ncn
감자재배법	ncn
감자튀김	ncn
감자피클	ncn
감잣골	nqq
감장	ncn
감전	ncpa
감전사고	ncn
감점	ncn
감정	ncn	ncpa
감정가	ncr
감정가격	ncn
감정결과	ncn
감정경험	ncn
감정관	ncr
감정기관	ncn
감정기복	ncpa
감정대립	ncpa
감정대응	ncpa
감정면	ncn
감정반응	ncpa
감정사	ncn
감정상	ncn
감정상태	ncn
감정생활	ncpa
감정서	ncn
감정싸움	ncn	ncpa
감정영역	ncpa
감정원	ncn
감정위원장	ncn
감정위원회	ncn
감정이입	ncpa
감정인	ncn
감정정화	ncpa
감정정화감	ncn
감정조절	ncpa
감정측면	ncn
감정통제	ncpa
감정평가	ncpa
감정평가기관	ncn
감정평가사	ncn
감정평화	ncn
감정폭발	ncpa
감정표시	ncpa
감정표현	ncpa
감정현상	ncn
감정환기	ncpa
감주석	nqpc
감즙	ncn
감지	ncpa
감지기	ncn
감지기능	ncn
감지덕지	ncpa
감쪽	ncn
감쪽같	paa
감쪽같이	mag
감차곤	nqpc
감찰	ncn
감찰조사	ncn
감찰활동	ncn
감창영	nqpc
감천	ncpa
감청	ncpa
감청빛	ncn
감초	ncn
감초가루	ncn
감촉	ncn
감촉성	ncn
감추	pvg
감축	ncpa
감축계획	ncpa
감축문제	ncn
감축요구	ncpa
감축추세	ncn
감취	ncpa
감칠맛	ncn
감탄	ncpa
감탄사	ncn
감탄서리	pvg
감탄형	ncn
감탕	ncn
감탕나무	ncn
감탕지대	ncn
감탕질	ncpa
감태	ncn
감태안	nqpc
감태영	nqpc
감태현	nqpc
감퇴	ncpa
감투	ncn	ncpa
감투밥	ncn
감투싸움	ncpa
감하	ncpa	pvg
감행	ncpa
감형	ncn
감형여부	ncn
감호	ncpa
감호병실	ncn
감호소	ncn
감호처분	ncpa
감홍	ncn
감화	ncpa
감화감동	ncps
감화력	ncn
감화원	ncr
감회	ncn
감흥	ncn
감히	mag
갑	nbu	ncn
갑각류	ncn
갑갑	ncps
갑갑증	ncn
갑곶진	nqq
갑군	ncn
갑규	nqpb
갑균	nqpb
갑근세	ncn
갑기	nqpb
갑남	nqpb
갑년	nqpb
갑돌	nqpc
갑동	nqpb
갑득	nqpb
갑례	nqpb
갑론을박	ncpa
갑류무역업	ncn
갑복	nqpb
갑봉	nqpb
갑부	ncn
갑사	nqq
갑사댕기	ncn
갑산	nqq
갑상	nqpb
갑상선	ncn
갑상선질환	ncn
갑생	nqpb
갑석	nqpb
갑선	nqpb
갑섭	nqpb
갑성	nqpb
갑수	nqpb
갑숙	nqpb
갑순	nqpb
갑술	nqpb
갑식	nqpb
갑신일록	ncn
갑신정변	nqq
갑연	nqpb
갑열	nqpb
갑영	nqpb
갑예	nqpb
갑오	ncn
갑오개혁	nqq
갑오개화파정권	ncn
갑오경장	nqq
갑오농민전쟁	ncn
갑옷	ncn
갑용	nqpb
갑을	ncn
갑이	nqpb
갑일	nqq
갑일전자	nqq
갑자	ncn
갑자기	mag
갑자사화	nqq
갑작	ncps
갑작스런	mma
갑작스레	mag
갑재	nqpb
갑절	mag	ncpa
갑절이상	ncn
갑정	nqpb
갑조	nqpb
갑종	ncn
갑종근로소득세	ncn
갑주	nqpb
갑준	nqpb
갑진	nqpb
갑진년	ncn
갑천	nqq
갑철	nqpb
갑충	ncn
갑태	nqpb
갑택	nqpb
갑판	ncn
갑판원	ncr
갑판장	ncr
갑현	nqpb
갑호	nqpb
갑환	nqpb
갑희	nqpb
값	ncn
값나가	pvg
값매기	pvg
값비싸	paa
값싸	paa
값어치	ncn
값없	paa
값인상	ncpa
값있	pvg
값지	paa
값하	pvg
갓	mag	ncn
갓걸이	ncn
갓고깔	ncn
갓길	ncn
갓나	pvg
갓난아기	ncn
갓난아기시절	ncn
갓난아이	ncn
갓난애	ncn
갓모	ncn
갓트킨트	nqq
갔다오	pvg
강	ncn	nqpa
강가	ncn
강가식	nqpc
강간	ncpa
강간문화	ncn
강간범	ncn
강간범인	ncn
강간범죄	ncpa
강간사건	ncn
강간살인	ncpa
강간자	ncn
강간충격	ncn
강간치사	ncn
강간치상	ncn
강간행위	ncpa
강간혐의	ncn
강감찬	nqq
강감청	nqpc
강갑구	nqpc
강갑규	nqpc
강갑남	nqpc
강갑동	nqpc
강갑례	nqpc
강갑석	nqpc
강갑선	nqpc
강갑성	nqpc
강갑세	nqq
강갑수	nqpc
강갑순	nqpc
강갑연	nqpc
강갑조	nqpc
강갑종	nqpc
강갑진	nqpc
강강남	nqpc
강강술래	ncn
강강영	nqpc
강강예	nqpc
강강윤	nqpc
강개격분	ncpa
강개근	nqpc
강건	ncps	nqq
강건구	nqpc
강건규	nqpc
강건기	nqpc
강건너	ncn
강건부	nqpc
강건상	nqpc
강건석	nqpc
강건선	nqpc
강건식	nqpc
강건영	nqpc
강건용	nqpc
강건우	nqpc
강건이	nqpc
강건주	nqpc
강건춘	nqpc
강건흥	nqpc
강건희	nqpc
강경	ncps	nqq
강경구	nqpc
강경국	nqpc
강경권	nqpc
강경규	nqpc
강경기류	ncn
강경남	nqpc
강경노선	ncn
강경대	nqq
강경대군	ncn
강경대폭행치사사건	nqq
강경돈	nqpc
강경란	nqpc
강경래	nqpc
강경렬	nqpc
강경례	nqpc
강경록	nqq
강경론	ncn
강경론자	ncn
강경만	nqpc
강경메시지	ncn
강경모	nqpc
강경목	nqpc
강경묵	nqpc
강경미	nqpc
강경민	nqpc
강경발언	ncn
강경방침	ncn
강경배	nqpc
강경보	nqpc
강경보수	ncn
강경보수그룹	ncn
강경보수세력	ncn
강경보수정권	ncn
강경보수주의	ncn
강경보수주의자	ncn
강경보수집단	ncn
강경보수파	ncn
강경분	nqpc
강경생	nqpc
강경석	nqpc
강경선	nqpc
강경섭	nqpc
강경성	nqpc
강경수	nqpc
강경숙	nqpc
강경순	nqpc
강경식	nqpc
강경아	nqpc
강경애	nqpc
강경연	nqpc
강경열	nqpc
강경영	nqpc
강경예	nqpc
강경오	nqpc
강경옥	nqpc
강경완	nqpc
강경우	nqpc
강경욱	nqpc
강경운	nqpc
강경원	nqpc
강경윤	nqpc
강경인	nqpc
강경일	nqpc
강경일변도	ncn
강경입장	ncn
강경자	nqpc
강경자세	ncn
강경정책	ncn
강경준	nqpc
강경중	nqpc
강경진	nqpc
강경찬	nqq
강경책	ncn
강경철	nqpc
강경탁	nqq
강경태	nqpc
강경태도	ncn
강경택	nqpc
강경투쟁	ncn
강경파	ncn
강경하	nqpc
강경한지	ncn
강경헌	nqpc
강경호	nqpc
강경화	nqpc
강경환	nqpc
강경훈	nqpc
강경희	nqpc
강경히	mag
강계	nqq
강계대	nqpc
강계라	nqpc
강계룡	nqpc
강계만	nqpc
강계부사	ncn
강계석	nqpc
강계수	nqpc
강계숙	nqpc
강계순	nqpc
강계식	nqpc
강계신	nqpc
강계원	nqpc
강계은	nqq
강계일	nqpc
강계화	nqpc
강계희	nqpc
강고	ncps
강고만	nqpc
강고히	mag
강곡수	nqpc
강공	ncn
강공돈	nqpc
강공림	nqpc
강공수	nqpc
강공원	nqpc
강공진	nqpc
강공희	nqpc
강과	ncps
강관	ncn
강관구	nqpc
강관근	nqq
강관류	ncn
강관모	nqpc
강관석	nqpc
강관선	nqq
강관숙	nqq
강관식	nqpc
강관업체	ncn
강관욱	ncn
강관원	nqpc
강관일	nqq
강관임	nqpc
강관제품	ncn
강관주	nqq
강관중	nqpc
강관현	nqpc
강관호	nqpc
강광국	nqq
강광규	nqpc
강광남	nqpc
강광덕	nqpc
강광범	nqpc
강광석	nqpc
강광선	nqpc
강광수	nqpc
강광순	nqpc
강광식	nqpc
강광언	nqpc
강광예	nqpc
강광용	nqpc
강광원	nqpc
강광일	nqpc
강광자	nqpc
강광철	nqpc
강광칠	ncn
강광현	nqpc
강광호	nqpc
강광환	nqpc
강광희	nqpc
강굉민	nqpc
강교사	ncn
강교상	nqpc
강교수	nqpc
강교중	nqpc
강교형	nqpc
강교환	nqpc
강구	ncn	ncpa
강구경	nqpc
강구관	nqpc
강구금	nqpc
강구남	nqpc
강구련	ncn
강구룡	nqpc
강구범	nqpc
강구복	nqpc
강구봉	nqpc
강구삼	nqpc
강구석	nqpc
강구선	nqpc
강구섭	nqpc
강구성	nqpc
강구연	nqpc
강구연안	ncn
강구영	nqpc
강구요	nqpc
강구용	nqpc
강구웅	nqpc
강구원	nqpc
강구인	nqpc
강구일	nqpc
강구일웅	nqpc
강구정	nqpc
강구종	nqpc
강구중	nqpc
강구창	nqpc
강구채	nqpc
강구철	nqpc
강구태	nqpc
강구표	nqpc
강구한	nqpc
강구현	nqpc
강구형	nqpc
강구홍	nqpc
강구화	nqpc
강국	ncn
강국련	nqpc
강국주	nqpc
강국중	nqpc
강국진	nqpc
강군	ncn
강군식	nqq
강군자	nqpc
강군희	nqpc
강권	ncn	ncpa
강권구	nqpc
강권식	nqpc
강권일	nqpc
강권진압	ncpa
강권통치	ncpa
강권폭력	ncn
강권행사	ncpa
강권호	nqpc
강귀길	nqq
강귀남	nqpc
강귀녀	nqpc
강귀분	nqpc
강귀석	nqpc
강귀성	nqpc
강귀순	nqpc
강귀열	nqpc
강귀영	nqpc
강귀예	nqpc
강귀완	nqpc
강귀원	nqpc
강귀자	nqpc
강귀철	nqq
강귀헌	nqpc
강귀형	nqpc
강귀희	nqpc
강규광	nqpc
강규님	nqpc
강규대	nqpc
강규만	nqpc
강규문	nqpc
강규범	nqpc
강규상	nqpc
강규석	nqpc
강규설	nqq
강규섭	nqpc
강규성	nqpc
강규수	nqpc
강규순	nqpc
강규여	nqpc
강규오	nqpc
강규임	nqpc
강규정	nqpc
강규찬	nqpc
강규창	nqpc
강규철	nqpc
강규택	nqq
강규현	nqpc
강규환	nqpc
강규희	nqpc
강균석	nqpc
강그리오사이드	ncn
강극	ncn
강근	nqpb
강근구	nqpc
강근규	nqpc
강근만	nqpc
강근모	nqpc
강근복	nqpc
강근수	nqpc
강근숙	nqpc
강근식	nqpc
강근아	nqpc
강근예	nqpc
강근옥	nqpc
강근원	nqpc
강근창	nqpc
강근탁	nqpc
강근형	nqpc
강근혜	nqpc
강근화	nqpc
강금규	nqpc
강금남	nqpc
강금녀	nqpc
강금돌	nqpc
강금두	nqpc
강금락	nqpc
강금례	nqpc
강금산	nqq
강금석	nqq
강금선	nqpc
강금성	nqpc
강금수	nqpc
강금숙	nqq
강금순	nqpc
강금식	nqpc
강금신	nqpc
강금실	nqpc
강금영	nqpc
강금예	nqpc
강금옥	nqpc
강금용	nqpc
강금원	nqpc
강금이	nqpc
강금자	nqpc
강금주	nqpc
강금중	nqpc
강금지	nqpc
강금천	nqpc
강금화	nqpc
강금환	nqpc
강금희	nqpc
강긍순	nqpc
강긍하	nqpc
강기	nqpb
강기권	nqpc
강기근	nqpc
강기남	nqpc
강기대	nqpc
강기돈	nqpc
강기동	nqpc
강기령어나	nqpc
강기례	nqpc
강기만	nqpc
강기모	nqpc
강기문	nqpc
강기미	nqpc
강기배	nqpc
강기백	nqpc
강기벽	nqpc
강기복	nqpc
강기봉	nqpc
강기서	nqpc
강기석	nqpc
강기선	nqpc
강기섭	nqpc
강기성	nqpc
강기송	nqq
강기수	nqpc
강기숙	nqpc
강기순	nqpc
강기슭	ncn
강기슭후미	ncn
강기식	nqpc
강기언	nqpc
강기연	nqpc
강기열	nqpc
강기영	nqpc
강기예	nqpc
강기오	nqpc
강기온	nqpc
강기완	nqpc
강기용	nqpc
강기우	nqpc
강기욱	nqpc
강기운	nqpc
강기웅	nqq
강기원	nqpc
강기윤	nqpc
강기은	nqpc
강기인	nqpc
강기전	nqpc
강기정	nqpc
강기조	nqpc
강기주	nqpc
강기준	nqpc
강기중	nqpc
강기찬	nqpc
강기창	nqpc
강기천	nqpc
강기철	nqpc
강기춘	nqq
강기태	nqpc
강기택	nqpc
강기필	ncn
강기현	nqpc
강기형	nqpc
강기호	nqpc
강기홍	nqpc
강기화	nqpc
강기환	nqpc
강기황	nqpc
강기훈	nqq
강기훈유서대필사건	nqq
강기훙	nqpc
강기희	nqpc
강길권	nqpc
강길남	nqpc
강길룡	nqq
강길림	nqpc
강길모	nqpc
강길봉	nqpc
강길부	ncn
강길상	nqpc
강길석	nqpc
강길선	nqpc
강길성	nqpc
강길수	nqpc
강길순	nqpc
강길식	nqpc
강길신	nqpc
강길예	nqpc
강길용	nqpc
강길웅	nqpc
강길원	nqpc
강길윤	nqq
강길자	nqpc
강길전	nqpc
강길정	nqpc
강길중	nqpc
강길진	nqpc
강길현	nqpc
강길환	nqpc
강나루	ncn
강나형	nqpc
강낙구	nqpc
강낙규	nqpc
강낙현	nqpc
강난규	nqpc
강난성	nqpc
강난순	nqpc
강난식	nqpc
강난영	nqpc
강난춘	nqpc
강난희	nqpc
강남	ncn	nqpb
강남갑	ncn
강남개발	ncn
강남경찰	ncn
강남경찰서	nqq
강남고	nqq
강남고속버스터미날	ncn
강남고속버스터미널	ncn
강남고속터미날	ncn
강남고속터미널	ncn
강남구	nqpc
강남구일대	nqq
강남권	ncn
강남규	nqpc
강남근	nqpc
강남길	nqpc
강남대	nqq
강남대로	ncn
강남맨션	ncn
강남모	nqpc
강남문사	ncn
강남버스터미널	nqq
강남병원	nqq
강남북균형발전	ncn
강남분화	ncpa
강남빌딩	ncn
강남상권	ncn
강남석	nqpc
강남선	nqpc
강남성모병원	nqq
강남성모병원지하차도	ncn
강남솔라	nqq
강남수	nqpc
강남숙	nqpc
강남순	nqpc
강남식	nqpc
강남신	nqpc
강남역	ncn
강남역부근	nqq
강남영	nqpc
강남오	nqpc
강남욱	nqpc
강남원	nqpc
강남이	nqpc
강남인	nqpc
강남일	nqpc
강남일대	ncn
강남재	nqpc
강남조	nqpc
강남주	nqq
강남준	nqpc
강남지식인	ncn
강남지역	ncn
강남지점차장	ncn
강남진	nqpc
강남철	nqpc
강남터미널	nqq
강남향	nqpc
강남흥	nqpc
강남희	nqpc
강낭대죽	ncn
강낭새끼	ncn
강낭숙구	ncn
강낭죽	ncn
강낭콩	ncn
강내구	nqpc
강내국	nqpc
강내권	nqpc
강내서	nqpc
강내석	nqpc
강내수	nqpc
강내식	nqpc
강내욱	nqpc
강냉이	ncn
강녕	ncn	ncpa	ncps
강노규	nqpc
강노산	nqpc
강노석	nqpc
강노순	nqpc
강노연	nqpc
강노원	nqq
강노현	nqpc
강능구	nqpc
강능권	nqq
강능규	nqpc
강능수	nqq
강능자	nqpc
강능지	nqpc
강다문	nqpc
강단	ncn
강단구	nqpc
강단비평	ncpa
강단비평가	ncn
강단지	paa
강달곤	nqpc
강달구	nqpc
강달삼	nqpc
강달선	nqpc
강달섭	nqpc
강달수	nqpc
강달순	nqpc
강달웅	nqpc
강달원	nqpc
강달제	nqq
강달종	nqpc
강달주	nqpc
강달회	nqpc
강당	ncn
강대	ncps
강대갑	nqpc
강대경	nqpc
강대관	nqpc
강대광	nqpc
강대국	ncn
강대국간	ncn
강대국자리	ncn
강대권	nqpc
강대규	nqpc
강대균	nqpc
강대근	nqpc
강대기	nqpc
강대길	nqpc
강대덕	nqpc
강대독	nqpc
강대두	nqpc
강대만	nqpc
강대문	nqpc
강대민	nqpc
강대보	nqpc
강대복	nqpc
강대봉	nqpc
강대삼	nqpc
강대석	nqpc
강대선	nqpc
강대섭	nqpc
강대성	nqpc
강대수	nqpc
강대순	nqpc
강대승	nqpc
강대식	nqpc
강대신	nqpc
강대안	nqpc
강대언	nqpc
강대업	nqpc
강대열	nqpc
강대엽	nqpc
강대영	nqpc
강대옥	nqpc
강대완	nqpc
강대용	nqpc
강대욱	ncn
강대운	nqpc
강대웅	nqpc
강대원	nqpc
강대유	nqpc
강대일	nqpc
강대임	nqpc
강대전	nqpc
강대정	nqpc
강대종	nqpc
강대준	nqpc
강대진	nqpc
강대창	nqpc
강대천	nqpc
강대철	nqpc
강대치	nqpc
강대학	nqpc
강대해	nqpc
강대헌	nqpc
강대현	nqpc
강대형	nqpc
강대호	nqpc
강대홍	nqpc
강대화	nqpc
강대흥	nqpc
강대희	nqpc
강덕	nqpb
강덕구	nqpc
강덕규	nqpc
강덕균	nqpc
강덕기	nqpc
강덕길	nqq
강덕남	nqpc
강덕녀	nqq
강덕두	nqpc
강덕례	nqpc
강덕명	nqpc
강덕서	nqq
강덕선	nqpc
강덕수	nqpc
강덕순	nqpc
강덕신	nqpc
강덕예	nqpc
강덕용	nqpc
강덕원	nqpc
강덕윤	nqpc
강덕은	nqpc
강덕인	nqpc
강덕일	nqpc
강덕임	nqpc
강덕자	nqpc
강덕재	nqpc
강덕주	nqq
강덕준	nqpc
강덕중	nqpc
강덕진	nqpc
강덕창	nqpc
강덕출	nqpc
강덕향	nqpc
강덕헌	nqpc
강덕현	nqpc
강덕형	nqpc
강덕홍	nqq
강덕환	nqpc
강덕흠	nqpc
강덕희	nqpc
강도	ncn	ncpa
강도강간	ncn
강도강간범죄	ncpa
강도경	nqpc
강도규	nqpc
강도근	ncn
강도높	paa
강도단	ncn
강도떼	ncn
강도떼에	ncn
강도령	nqpc
강도범	ncn
강도사	ncn
강도사건	ncn
강도살인	ncpa
강도살인사건	ncn
강도상해	ncn
강도선	nqpc
강도성	nqq
강도세	nqpc
강도순	nqpc
강도식	nqpc
강도영	nqpc
강도원	nqpc
강도익	nqpc
강도일	nqq
강도저하	ncpa
강도정	nqpc
강도죄	ncn
강도철	nqpc
강도행각	ncn	ncpa
강도행위	ncn	ncpa
강도현	nqq
강도희	nqpc
강독단위	ncn
강돈	ncn
강돈묵	nqpc
강돈희	nqpc
강돌순	nqpc
강동	nqq
강동갑	ncn
강동강동	mag
강동걸	nqpc
강동구	nqpc
강동규	nqpc
강동균	nqpc
강동근	nqpc
강동렬	nqpc
강동례	nqpc
강동만	nqq
강동명	nqpc
강동모	nqpc
강동문	nqpc
강동배	nqpc
강동복	nqpc
강동석	nqpc
강동선	nqpc
강동섭	nqpc
강동성	nqpc
강동성심병원	ncn
강동수	nqpc
강동순	nqpc
강동술	nqpc
강동식	nqpc
강동신	nqpc
강동언	nqq
강동연	nqpc
강동열	nqpc
강동영	nqpc
강동예	nqpc
강동옥	nqpc
강동완	nqpc
강동우	nqpc
강동욱	nqpc
강동운	nqq
강동원	nqpc
강동월	nqpc
강동윤	nqpc
강동율	nqpc
강동인	nqpc
강동일	nqpc
강동임	nqpc
강동자	nqpc
강동재	nqpc
강동조	nqpc
강동주	nqpc
강동준	nqpc
강동진	nqpc
강동천	nqpc
강동철	nqpc
강동춘	nqpc
강동칠	nqq
강동헌	nqpc
강동현	nqpc
강동호	nqpc
강동화	nqpc
강동훈	nqpc
강동희	nqpc
강두규	nqpc
강두근	nqpc
강두기	nqpc
강두리	nqpc
강두석	nqpc
강두선	nqpc
강두섭	nqpc
강두성	nqpc
강두식	nqpc
강두암	nqpc
강두연	nqpc
강두원	nqpc
강두진	nqpc
강두태	nqpc
강두한	nqpc
강두현	nqpc
강두형	nqpc
강두환	nqpc
강두희	nqpc
강둑	ncn
강둑길	ncn
강득규	nqpc
강득민	nqq
강득신	nqpc
강득원	nqpc
강득중	nqpc
강득춘	nqpc
강등	ncpa
강등륭미	nqpc
강등차	nqq
강디약	nqq
강락정	nqpc
강락주	nqpc
강란선	nqpc
강란실	nqpc
강란희	nqpc
강래	nqpb
강래균	nqpc
강래근	nqpc
강래길	nqpc
강래동	nqpc
강래복	nqpc
강래석	nqpc
강래성	nqpc
강래순	nqpc
강래철	nqpc
강력	ncn	ncps
강력계반장	ncn
강력규제	ncpa
강력대응	ncn
강력범죄	ncn
강력부	ncn
강력사건	ncn
강력사범	ncn
강력히	mag
강련화	nqq
강렬	ncn	ncps
강령	ncn	ncpa
강령차원	ncn
강령초안	ncn
강령현	ncn
강례	nqpb
강로	nqpb
강론	ncpa
강뢰하	nqpc
강루수	nqpc
강릉	nqq
강릉갑	ncn
강릉길	ncn
강릉대	nqq
강릉대군	nqq
강릉매화전	ncn
강릉사범	ncn
강릉시	ncn
강리나	nqq
강리용	nqq
강린	nqq
강린삼	nqq
강린석	nqpc
강림	ncpa
강마르	paa.irrlu
강마리아	nqpc
강마을	ncn
강막내	nqpc
강만구	nqpc
강만권	nqpc
강만규	nqpc
강만근	nqpc
강만기	nqpc
강만길	nqq
강만덕	nqpc
강만서	nqpc
강만석	nqpc
강만선	nqpc
강만섭	nqpc
강만수	nqpc
강만순	nqpc
강만식	nqpc
강만영	nqq
강만우	nqpc
강만재	nqpc
강만주	nqpc
강만준	nqpc
강만춘	nqpc
강만태	nqpc
강만형	nqpc
강만희	nqpc
강말만	nqpc
강말숙	nqpc
강매	ncpa
강매선	nqpc
강매원	nqpc
강맹구	nqq
강맹희	nqpc
강면구	nqpc
강면수	nqq
강면의	nqpc
강면태	nqpc
강면호	nqpc
강면희	nqpc
강명걸	nqpc
강명검	nqpc
강명경	nqpc
강명교	nqpc
강명구	nqpc
강명규	nqpc
강명근	nqpc
강명기	nqpc
강명길	nqpc
강명남	nqpc
강명덕	nqpc
강명돈	nqq
강명동	nqpc
강명란	nqpc
강명래	nqpc
강명례	nqpc
강명록	nqpc
강명모	nqpc
강명복	nqpc
강명산	nqq
강명서	nqpc
강명석	nqpc
강명선	nqpc
강명섭	nqpc
강명성	nqpc
강명수	nqpc
강명숙	nqpc
강명순	nqpc
강명술	nqpc
강명식	nqpc
강명신	nqpc
강명실	nqpc
강명심	nqpc
강명암	nqpc
강명애	nqpc
강명열	nqpc
강명예	nqpc
강명오	nqpc
강명옥	nqpc
강명욱	nqpc
강명운	nqpc
강명원	nqpc
강명의	nqpc
강명일	nqpc
강명자	nqpc
강명주	nqpc
강명준	nqpc
강명진	nqpc
강명철	nqq
강명해	nqpc
강명현	nqpc
강명호	nqpc
강명화	nqpc
강명환	nqpc
강명훈	nqpc
강명흥	nqpc
강명희	nqpc
강모섭	nqpc
강모세	nqpc
강모영	nqpc
강목	ncn
강목단	nqpc
강몽아	nqpc
강묘영	nqpc
강묘흥	nqq
강무	ncpa
강무균	nqpc
강무등	nqpc
강무상	nqpc
강무석	nqpc
강무선	nqpc
강무연	nqpc
강무영	nqpc
강무웅	nqpc
강무중	nqpc
강무호	nqpc
강무훈	nqpc
강무희	nqpc
강문	nqpb
강문갑	nqpc
강문경	nqpc
강문구	nqpc
강문국	nqpc
강문규	nqpc
강문기	nqpc
강문길	nqpc
강문대	nqq
강문모	nqpc
강문복	nqpc
강문삼	nqq
강문상	nqq
강문석	nqpc
강문선	nqpc
강문섭	nqpc
강문성	nqpc
강문수	nqpc
강문숙	nqpc
강문순	nqpc
강문식	nqpc
강문신	nqpc
강문영	nqq
강문옥	nqpc
강문우	nqpc
강문욱	nqq
강문자	nqpc
강문재	nqpc
강문종	nqpc
강문주	nqpc
강문중	nqpc
강문철	nqq
강문태	nqq
강문현	nqpc
강문호	nqpc
강문흥	nqpc
강문희	nqpc
강물	ncn
강물고기	ncn
강물굽이	ncn
강물마름현상	ncn
강미	nqpb
강미경	nqpc
강미라	nqpc
강미란	nqpc
강미령	nqpc
강미복	nqpc
강미석	nqpc
강미선	nqpc
강미성	nqpc
강미숙	nqpc
강미순	nqpc
강미애	nqpc
강미양	nqpc
강미연	nqpc
강미영	nqpc
강미옥	nqpc
강미원	nqpc
강미이	nqpc
강미자	nqpc
강미정	nqpc
강미향	nqpc
강미형	nqpc
강미혜	nqpc
강미혜자	nqpc
강미화	nqpc
강미희	nqpc
강민	nqpb
강민경	nqq
강민곤	nqpc
강민관	nqpc
강민구	nqpc
강민규	nqpc
강민기	nqpc
강민삼	nqq
강민석	nqpc
강민선	nqpc
강민성	nqpc
강민수	nqpc
강민숙	nqpc
강민순	nqpc
강민식	nqpc
강민애	nqpc
강민영	nqpc
강민용	nqpc
강민자	nqpc
강민정	nqpc
강민조	nqq
강민창	nqq
강민철	nqpc
강민학	nqpc
강민호	nqpc
강바닥	ncn
강바람	ncn
강박	ncpa
강박관념	ncn
강박사고	ncn
강박신경증	ncn
강박증	ncn
강박행동	ncpa
강반석	nqq
강반선	nqpc
강반주	nqpc
강방식	nqpc
강방원	nqpc
강방자	nqpc
강방희	nqpc
강배구	nqpc
강배식	nqpc
강백기	nqpc
강백수	nqpc
강백순	nqpc
강백식	nqpc
강백영	nqpc
강백임	nqpc
강백환	nqpc
강범모	nqpc
강범석	nqpc
강범성	nqpc
강범수	nqpc
강범순	nqpc
강범식	nqpc
강범열	nqpc
강범용	nqpc
강범진	nqq
강범현	nqpc
강법순	nqpc
강법주	nqpc
강벙욱	nqpc
강변	ncn	ncpa
강변도로	ncn
강변로	ncn
강변북로	ncn
강변유원지	ncn
강변일대	ncn
강별모	nqpc
강병	ncn
강병갑	nqpc
강병걸	nqpc
강병관	nqpc
강병교	nqpc
강병구	nqpc
강병국	nqpc
강병권	nqpc
강병규	nqpc
강병균	nqpc
강병근	nqpc
강병기	nqpc
강병길	nqpc
강병남	nqpc
강병노	nqpc
강병님	nqpc
강병대	nqpc
강병덕	nqpc
강병도	nqpc
강병두	nqpc
강병례	nqpc
강병로	nqpc
강병록	nqpc
강병룡	nqpc
강병립	nqpc
강병만	nqpc
강병모	nqpc
강병무	nqpc
강병문	nqpc
강병민	nqpc
강병석	nqpc
강병선	nqpc
강병섭	nqpc
강병세	nqpc
강병송	nqpc
강병수	nqpc
강병숙	nqpc
강병순	nqpc
강병승	nqpc
강병식	nqpc
강병실	nqq
강병악	nqpc
강병열	nqpc
강병예	nqpc
강병오	nqpc
강병옥	nqpc
강병용	nqpc
강병우	nqpc
강병욱	nqpc
강병운	nqpc
강병원	nqpc
강병위	nqpc
강병은	nqpc
강병을	nqpc
강병이	nqpc
강병인	nqq
강병일	nqpc
강병임	nqpc
강병전	nqpc
강병절	nqpc
강병조	nqq
강병주	nqpc
강병준	nqpc
강병직	nqpc
강병진	nqpc
강병찬	nqpc
강병채	nqpc
강병천	nqpc
강병철	nqpc
강병춘	nqpc
강병태	nqpc
강병필	nqpc
강병하	nqpc
강병학	nqq
강병헌	nqpc
강병혁	nqpc
강병현	nqpc
강병호	nqpc
강병환	nqpc
강병효	nqpc
강병훈	nqpc
강병희	nqpc
강보	ncn
강보경	nqpc
강보비	nqpc
강보선	nqpc
강보성	nqq
강보순	nqpc
강보영	nqpc
강보원	nqpc
강보인	nqpc
강보합세	ncpa
강복갑	nqpc
강복규	nqpc
강복금	nqpc
강복기	nqpc
강복남	nqpc
강복단	nqpc
강복덕	nqpc
강복동	nqpc
강복란	nqpc
강복례	nqpc
강복립	nqpc
강복만	nqpc
강복모	nqq
강복석	nqpc
강복선	nqpc
강복수	nqpc
강복순	nqpc
강복실	nqpc
강복영	nqpc
강복예	nqpc
강복운	nqpc
강복원	nqpc
강복윤	nqpc
강복임	nqpc
강복자	nqpc
강복직	nqq
강복철	nqpc
강복하	nqpc
강복형	nqpc
강복호	nqpc
강복환	nqpc
강복희	nqpc
강본구	nqpc
강본도웅	nqpc
강본석	nqpc
강본이웅	nqpc
강봉구	nqpc
강봉국	nqpc
강봉규	nqpc
강봉균	nqpc
강봉근	nqq
강봉기	nqpc
강봉길	nqpc
강봉녀	nqpc
강봉님	nqpc
강봉덕	nqpc
강봉동	nqpc
강봉득	nqpc
강봉만	nqpc
강봉명	nqpc
강봉산	nqpc
강봉삼	nqpc
강봉석	nqpc
강봉선	nqpc
강봉성	nqpc
강봉세	nqpc
강봉수	nqpc
강봉순	nqpc
강봉술	nqpc
강봉식	nqpc
강봉신	nqpc
강봉암	nqpc
강봉애	nqpc
강봉열	nqpc
강봉염	nqpc
강봉옥	nqpc
강봉용	nqpc
강봉원	nqpc
강봉의	nqpc
강봉임	nqpc
강봉자	nqpc
강봉정	nqpc
강봉주	nqpc
강봉직	nqq
강봉진	nqpc
강봉철	nqpc
강봉추	nqpc
강봉춘	nqpc
강봉칠	nqq
강봉택	nqpc
강봉학	nqpc
강봉현	nqpc
강봉호	nqq
강봉환	nqpc
강봉훈	nqpc
강봉희	nqpc
강부구	nqpc
강부미자	nqpc
강부성	nqpc
강부식	nqpc
강부영	nqpc
강부옥	nqpc
강부자	nqpc
강부현	nqpc
강북	ncn	nqq
강북구	ncn
강북구청총무과장	ncn
강북주	nqpc
강북지역	ncn
강분남	nqpc
강분순	nqpc
강분식	nqpc
강분출	nqpc
강분현	nqpc
강붕석	nqq
강빈화	nqpc
강사	ncr
강사길	nqpc
강사료	ncn
강사봉	nqpc
강사선	nqpc
강사순	nqpc
강사영	nqpc
강사원	nqpc
강사직	ncn
강사진	ncn
강사홍	nqpc
강사희	nqpc
강산	ncn
강산성	ncn
강산에	nqq
강산제	ncn
강산홍	nqq
강삼구	nqpc
강삼도	nqpc
강삼랑	nqpc
강삼례	nqpc
강삼록	nqpc
강삼분	nqpc
강삼선	nqpc
강삼섭	nqpc
강삼수	nqpc
강삼순	nqpc
강삼신	nqpc
강삼애	nqpc
강삼영	nqpc
강삼우	nqpc
강삼재	nqpc
강삼재총장	ncn
강삼현	nqpc
강삼환	nqpc
강삼희	nqpc
강상	ncn
강상갑	nqpc
강상교	nqpc
강상구	nqpc
강상규	nqpc
강상균	nqpc
강상근	nqpc
강상금	nqpc
강상기	nqpc
강상길	nqpc
강상대	nqpc
강상덕	nqpc
강상도	nqpc
강상동	nqpc
강상래	nqpc
강상릉	nqq
강상만	nqpc
강상명	nqpc
강상묵	nqpc
강상배	nqpc
강상백	nqpc
강상범	nqpc
강상봉	nqpc
강상섭	nqpc
강상수	nqpc
강상순	nqpc
강상식	nqpc
강상신	nqpc
강상언	ncn
강상연	nqpc
강상열	nqpc
강상옥	nqpc
강상욱	nqpc
강상운	nqpc
강상원	nqpc
강상은	nqq
강상일	nqpc
강상주	nqpc
강상준	nqq
강상진	nqpc
강상철	nqpc
강상춘	nqq
강상탁	nqpc
강상필	nqq
강상학	nqpc
강상혁	nqpc
강상현	nqpc
강상호	nqpc
강상화	nqpc
강상훈	nqpc
강상희	nqpc
강생	ncn
강생규	nqpc
강서	nqq
강서갑	ncn
강서구	nqpc
강서구역	ncn
강서로	ncn
강서성	nqq
강서영	nqpc
강서영업본부	ncn
강서용	nqpc
강서운	nqpc
강서웅	nqpc
강서원	nqq
강서을	ncn
강서조	nqpc
강서촌	nqq
강서희	nqpc
강석	nqpb
강석견	nqpc
강석경	nqpc
강석고	nqpc
강석관	nqpc
강석광	nqpc
강석구	nqpc
강석군	nqpc
강석권	nqpc
강석귀	nqpc
강석규	nqpc
강석균	nqpc
강석근	nqpc
강석금	nqpc
강석기	nqpc
강석길	nqpc
강석남	nqpc
강석노	nqpc
강석덕	nqpc
강석도	nqpc
강석돈	nqpc
강석돌	nqpc
강석동	nqpc
강석두	nqpc
강석란	nqpc
강석래	nqpc
강석례	nqpc
강석룡	nqpc
강석립	nqpc
강석만	nqpc
강석매	nqpc
강석명	nqpc
강석모	nqpc
강석무	nqpc
강석문	nqpc
강석민	nqpc
강석배	nqpc
강석범	nqpc
강석보	nqpc
강석복	nqpc
강석봉	nqpc
강석부	nqpc
강석분	nqpc
강석붕	nqpc
강석빈	nqpc
강석산	nqpc
강석상	nqpc
강석수	nqpc
강석순	nqpc
강석숭	nqpc
강석신	nqpc
강석안	nqpc
강석암	nqpc
강석애	nqpc
강석언	nqpc
강석연	nqpc
강석열	nqpc
강석영	nqpc
강석오	nqpc
강석올	nqpc
강석완	nqpc
강석용	nqpc
강석우	nqpc
강석운	nqpc
강석웅	nqpc
강석원	nqpc
강석윤	nqpc
강석율	nqpc
강석이	nqpc
강석인	nqpc
강석일	nqpc
강석임	nqpc
강석재	nqpc
강석정	nqpc
강석조	nqpc
강석종	nqpc
강석주	nqpc
강석준	nqpc
강석중	nqpc
강석진	nqpc
강석찬	nqpc
강석창	nqpc
강석채	nqpc
강석천	nqpc
강석철	nqpc
강석초	nqpc
강석출	nqpc
강석태	nqpc
강석표	nqpc
강석필	nqq
강석하	nqpc
강석헌	nqpc
강석현	nqpc
강석형	nqpc
강석호	nqpc
강석홍	nqpc
강석화	nqpc
강석환	nqpc
강석황	nqpc
강석회	nqpc
강석훈	nqpc
강석휘	nqq
강석흠	nqpc
강석흥	nqpc
강석희	nqpc
강선	nqpb
강선강	nqq
강선경	nqpc
강선교	nqpc
강선구	nqpc
강선국	nqpc
강선규	nqpc
강선균	nqpc
강선근	nqpc
강선기	nqpc
강선남	nqpc
강선란	nqpc
강선모	nqpc
강선무	nqpc
강선미	nqpc
강선배	nqpc
강선보	nqq
강선봉	nqpc
강선빈	nqq
강선수	nqpc
강선숙	nqpc
강선순	nqpc
강선식	nqpc
강선실	nqq
강선심	nqpc
강선영	nqpc
강선오	nqpc
강선옥	nqpc
강선용	nqpc
강선우	nqpc
강선웅	nqpc
강선의	nqpc
강선이	nqpc
강선익	nqpc
강선일	nqpc
강선임	nqpc
강선자	nqpc
강선장	nqpc
강선준	nqpc
강선중	nqpc
강선철	nqpc
강선택	nqpc
강선하	nqpc
강선학	nqpc
강선현	nqpc
강선호	nqpc
강선홍	nqq
강선화	nqpc
강선희	nqpc
강설경	nqpc
강설량	ncn
강설자	nqpc
강섭	nqpb
강섭이	nqpc
강성	ncn	ncps	nqpb
강성곤	nqpc
강성관	nqpc
강성구	nqpc
강성국	nqpc
강성군	nqpc
강성권	nqpc
강성규	nqpc
강성균	nqpc
강성근	nqpc
강성기	nqpc
강성기조	ncn
강성길	nqpc
강성남	nqpc
강성녀	nqpc
강성대	nqpc
강성덕	nqpc
강성돈	nqpc
강성동	nqpc
강성두	nqpc
강성락	nqpc
강성래	nqpc
강성렬	nqq
강성례	nqpc
강성록	nqq
강성룡	nqq
강성률	nqpc
강성만	nqpc
강성명	nqpc
강성모	nqpc
강성목	nqpc
강성무	nqpc
강성묵	nqpc
강성문	nqpc
강성미	nqpc
강성민	nqpc
강성배	nqpc
강성범	nqpc
강성복	nqpc
강성봉	nqpc
강성분	nqpc
강성산	nqq
강성삼	nqq
강성석	nqpc
강성수	nqpc
강성숙	nqpc
강성순	nqpc
강성술	nqpc
강성식	nqpc
강성신	nqpc
강성애	nqpc
강성언	nqpc
강성업	nqpc
강성역	nqpc
강성연	nqpc
강성열	nqpc
강성영	nqpc
강성예	nqpc
강성오	nqpc
강성옥	nqpc
강성용	nqpc
강성우	nqpc
강성욱	nqpc
강성원	nqpc
강성윤	nqpc
강성은	nqpc
강성이	nqpc
강성익	nqpc
강성인물	ncn
강성일	nqpc
강성자	nqpc
강성재	nqpc
강성점	nqpc
강성종	nqpc
강성주	nqpc
강성준	nqpc
강성중	nqpc
강성진	nqpc
강성채	nqpc
강성천	nqpc
강성철	nqpc
강성춘	nqpc
강성탁	nqpc
강성태	nqpc
강성택	nqpc
강성투쟁	ncpa
강성평	nqpc
강성필	nqpc
강성하	nqpc
강성학	nqpc
강성한	nqpc
강성혁	nqpc
강성현	nqpc
강성호	nqpc
강성환	nqpc
강성훈	nqpc
강성휘	nqq
강성흠	nqpc
강성희	nqpc
강세	ncn
강세경	nqpc
강세구조	ncn
강세국	nqq
강세규	nqpc
강세기	nqpc
강세분야	ncn
강세빈	nqpc
강세선	nqpc
강세수	nqpc
강세열	nqpc
강세영	nqpc
강세원	nqpc
강세유지	ncn
강세은	nqpc
강세음	ncn
강세음절	ncn
강세의	nqpc
강세종	nqpc
강세지역	ncn
강세진	nqpc
강세창	nqpc
강세철	nqpc
강세태	nqpc
강세품목	ncn
강세행진	ncpa
강세혁	nqq
강세황	ncn
강세훈	nqpc
강세휘	nqpc
강세희	nqpc
강셕규	nqpc
강소녀	nqpc
강소덕	nqpc
강소선	nqpc
강소영	nqq
강소원	nqpc
강소자	nqpc
강소정	nqpc
강소제	nqpc
강소조	nqpc
강소출	nqpc
강소희	nqpc
강속구	ncn
강송규	nqpc
강송림	nqpc
강송순	nqpc
강송자	nqpc
강송춘	nqq
강쇠	nqpc
강수	nqpb
강수경	nqpc
강수구	nqpc
강수규	nqpc
강수근	nqpc
강수길	nqpc
강수남	nqpc
강수덕	nqq
강수동	nqpc
강수득	nqpc
강수량	ncn
강수린	nqq
강수림	nqq
강수만	nqpc
강수명	nqpc
강수미	nqpc
강수복	nqpc
강수봉	nqpc
강수석	nqpc
강수선	nqpc
강수성	nqpc
강수안	nqpc
강수애	nqpc
강수연	nqpc
강수영	nqpc
강수옥	nqpc
강수용	nqpc
강수웅	nqpc
강수원	nqpc
강수월	nqpc
강수일	nqpc
강수임	nqpc
강수자	nqpc
강수재	nqpc
강수정	nqpc
강수지	nqq
강수진	nqpc
강수철	nqpc
강수헌	nqpc
강수현	nqpc
강수형	nqpc
강수환	nqpc
강수희	nqpc
강숙	nqpb
강숙경	nqpc
강숙규	nqpc
강숙난	nqpc
강숙영	nqpc
강숙원	nqpc
강숙이	nqpc
강숙자	nqpc
강숙환	nqpc
강숙희	nqpc
강순	nqpb
강순건	nqpc
강순경	nqq
강순관	nqpc
강순구	nqpc
강순귀	nqpc
강순규	nqpc
강순금	nqpc
강순기	nqpc
강순길	nqpc
강순남	nqpc
강순녀	nqpc
강순님	nqpc
강순단	nqpc
강순달	nqpc
강순덕	nqpc
강순도	nqpc
강순득	nqpc
강순례	nqpc
강순만	nqpc
강순모	nqpc
강순범	nqq
강순복	nqpc
강순봉	nqpc
강순분	nqpc
강순석	nqpc
강순섭	nqpc
강순성	nqpc
강순식	nqpc
강순심	nqpc
강순애	nqpc
강순여	nqpc
강순영	nqpc
강순예	nqpc
강순오	nqpc
강순옥	nqpc
강순용	nqpc
강순원	nqpc
강순의	nqpc
강순이	nqpc
강순임	nqpc
강순자	nqpc
강순주	nqpc
강순지	nqpc
강순진	nqpc
강순천	nqpc
강순철	nqpc
강순학	nqpc
강순향	nqpc
강순혜	nqpc
강순호	nqpc
강순화	nqpc
강순희	nqpc
강슛	ncn
강스	nqq
강습	ncn
강습료	ncn
강습비	ncn
강습소	ncn
강습회	ncn
강승개	nqq
강승계	nqpc
강승구	nqpc
강승국	nqpc
강승권	nqpc
강승규	nqpc
강승남	nqpc
강승래	nqpc
강승모	nqpc
강승묵	nqpc
강승배	nqpc
강승범	nqpc
강승복	nqpc
강승서	nqpc
강승석	nqpc
강승순	nqpc
강승언	nqpc
강승연	nqpc
강승열	nqpc
강승원	nqpc
강승의	nqq
강승자	nqpc
강승찬	nqpc
강승천	nqpc
강승철	nqpc
강승춘	nqq
강승탁	nqpc
강승태	nqq
강승택	nqpc
강승현	nqpc
강승호	nqpc
강승환	nqq
강승희	nqpc
강시분	nqpc
강시성	nqq
강시애	nqpc
강시열	nqpc
강시옥	nqpc
강시용	nqpc
강시우	nqpc
강시원	nqpc
강시종	nqpc
강시춘	nqpc
강시탁	nqpc
강시태	nqpc
강시현	nqpc
강시호	nqpc
강시홍	nqpc
강시화	nqpc
강식	nqpb
강신각	nqpc
강신갑	nqpc
강신걸	nqpc
강신경	nqpc
강신곤	nqpc
강신관	nqpc
강신광	nqpc
강신교	nqpc
강신구	nqpc
강신국	nqpc
강신권	nqpc
강신규	nqpc
강신균	nqpc
강신극	nqpc
강신근	nqpc
강신기	nqpc
강신길	nqpc
강신남	nqpc
강신녀	nqq
강신달	nqpc
강신당	ncn
강신대	nqpc
강신덕	nqpc
강신돈	nqpc
강신동	nqpc
강신득	nqpc
강신란	nqpc
강신례	nqpc
강신록	nqpc
강신만	nqpc
강신면	nqpc
강신명	nqpc
강신목	nqpc
강신무	nqpc
강신묵	nqpc
강신민	nqpc
강신범	nqpc
강신보	nqpc
강신복	nqpc
강신봉	nqpc
강신부	nqpc
강신분	nqpc
강신상	nqpc
강신석	nqpc
강신선	nqpc
강신섭	nqq
강신성	nqpc
강신수	nqpc
강신숙	nqpc
강신순	nqpc
강신술	nqpc
강신승	nqpc
강신암	nqpc
강신애	nqpc
강신억	nqpc
강신업	nqpc
강신연	nqpc
강신열	nqpc
강신영	nqpc
강신예	nqpc
강신오	nqpc
강신옥	nqpc
강신용	nqpc
강신우	nqpc
강신욱	nqpc
강신웅	nqpc
강신원	nqpc
강신윤	nqpc
강신익	nqpc
강신일	nqpc
강신자	nqpc
강신재	nqpc
강신정	nqpc
강신제	nqpc
강신조	nqpc
강신종	nqpc
강신주	nqpc
강신준	nqpc
강신직	nqpc
강신진	nqpc
강신찬	nqpc
강신천	nqpc
강신철	nqpc
강신춘	nqpc
강신출	nqpc
강신태	nqpc
강신택	nqpc
강신평	nqpc
강신표	nqpc
강신필	nqpc
강신학	nqpc
강신한	nqpc
강신행	nqpc
강신혁	nqpc
강신현	nqpc
강신호	nqpc
강신홍	nqpc
강신화	nqpc
강신환	nqpc
강신회	nqpc
강신훈	nqpc
강신흠	nqpc
강신흥	nqpc
강신희	nqpc
강실경	nqpc
강심	ncn
강심석	nqpc
강씨	ncn
강씨돌	nqpc
강아지	ncn
강아지꼴	ncn
강아지집	ncn
강아지풀	ncn
강안	ncn	nqq
강안거리	ncn
강안기	nqpc
강안나	nqpc
강안성	nqpc
강압	ncpa
강압권력	ncn
강압기	ncn
강압수사	ncn
강압여부	ncn
강압정치	ncpa
강애란	nqpc
강애선	nqpc
강애숙	nqpc
강애순	nqpc
강애영	nqpc
강애자	nqpc
강약	ncn
강약운	nqpc
강약조절	ncpa
강양구	nqpc
강양규	nqpc
강양근	nqpc
강양기	nqpc
강양길	nqpc
강양례	nqpc
강양모	nqpc
강양선	nqpc
강양수	nqpc
강양순	nqpc
강양식	nqpc
강양예	nqpc
강양완	nqpc
강양욱	nqq
강양원	nqpc
강양인	nqpc
강양일	nqpc
강양임	nqpc
강양자	nqpc
강양혜	nqpc
강양화	nqpc
강양희	nqpc
강언구	nqpc
강언년	nqpc
강언덕	ncn
강언수	nqpc
강언용	nqpc
강여룡	nqq
강여모	nqpc
강여선	nqq
강여진	nqpc
강역	ncn
강연	ncpa
강연경	nqpc
강연관	nqpc
강연구	nqpc
강연국	nqpc
강연규	nqpc
강연근	nqpc
강연대	nqpc
강연덕	nqpc
강연만	nqpc
강연모	nqpc
강연모습	ncn
강연무	nqpc
강연묵	nqpc
강연문	nqpc
강연민	nqpc
강연배	nqpc
강연석	nqpc
강연석상	ncn
강연선	nqpc
강연성	nqpc
강연수	nqpc
강연숙	nqpc
강연순	nqpc
강연스케줄	ncn
강연승	nqpc
강연시	ncn
강연시간	ncn
강연식	nqpc
강연실	nqpc
강연심	nqpc
강연언	nqpc
강연옥	nqpc
강연요청	ncpa
강연용	nqpc
강연우	nqpc
강연욱	ncn
강연임	nqpc
강연자	nqpc
강연재	nqpc
강연제	nqpc
강연주	nqpc
강연주제	ncn
강연중	nqpc
강연직	nqpc
강연진	nqpc
강연학	nqq
강연호	nqpc
강연홍	nqpc
강연화	nqpc
강연회	ncn
강연희	nqpc
강열	nqpb
강열애	nqpc
강영	nqpb
강영갑	nqpc
강영걸	nqq
강영경	nqpc
강영관	nqpc
강영구	nqpc
강영국	nqpc
강영군	nqpc
강영권	nqpc
강영규	nqpc
강영균	nqpc
강영근	nqpc
강영금	nqpc
강영기	nqpc
강영길	nqpc
강영남	nqpc
강영대	nqpc
강영덕	nqpc
강영돈	nqpc
강영득	nqpc
강영란	nqpc
강영랑	nqpc
강영래	nqpc
강영렬	nqq
강영례	nqpc
강영록	nqpc
강영룡	nqq
강영만	nqpc
강영매	nqpc
강영명	nqpc
강영모	nqpc
강영묘	nqpc
강영무	nqpc
강영미	nqpc
강영민	nqpc
강영배	nqpc
강영복	nqpc
강영북	nqpc
강영빈	nqpc
강영삼	nqpc
강영서	nqpc
강영석	nqpc
강영선	nqpc
강영섭	nqpc
강영성	nqpc
강영수	nqpc
강영숙	nqpc
강영순	nqpc
강영식	nqpc
강영신	nqpc
강영실	nqpc
강영애	nqpc
강영열	nqpc
강영영	nqpc
강영예	nqpc
강영옥	nqpc
강영온	nqpc
강영욱	nqpc
강영운	nqpc
강영원	nqpc
강영은	nqpc
강영이	nqpc
강영인	nqpc
강영일	nqpc
강영임	nqpc
강영자	nqpc
강영재	nqpc
강영조	nqpc
강영주	nqpc
강영준	nqpc
강영중	nqpc
강영진	nqpc
강영찬	nqpc
강영창	nqpc
강영천	nqpc
강영철	nqpc
강영탁	nqpc
강영태	nqpc
강영팔	nqpc
강영표	nqpc
강영필	nqpc
강영하	nqpc
강영학	nqpc
강영한	nqpc
강영헌	nqpc
강영혜	nqpc
강영호	nqpc
강영화	nqpc
강영환	nqpc
강영회	nqpc
강영훈	nqpc
강영휘	nqpc
강영흠	nqpc
강영희	nqpc
강예규	nqpc
강예근	nqpc
강예림	nqpc
강예모	nqpc
강예묵	nqpc
강예순	nqpc
강예식	nqpc
강예원	nqpc
강예자	nqpc
강오구	nqpc
강오권	nqpc
강오규	nqpc
강오기	nqpc
강오례	nqpc
강오복	nqpc
강오산	nqpc
강오석	nqpc
강오순	nqpc
강오식	nqpc
강오종	nqpc
강오중	nqpc
강오한	nqpc
강오희	nqpc
강옥	nqpb
강옥경	nqpc
강옥균	nqpc
강옥금	nqpc
강옥남	nqpc
강옥님	nqpc
강옥란	nqpc
강옥련	nqpc
강옥봉	nqpc
강옥분	nqpc
강옥선	nqpc
강옥성	nqpc
강옥숙	nqpc
강옥순	nqpc
강옥예	nqpc
강옥운	nqpc
강옥이	nqpc
강옥임	nqpc
강옥자	nqpc
강옥정	nqpc
강옥진	nqpc
강옥춘	nqpc
강옥환	nqpc
강옥희	nqpc
강온양면	ncn
강완구	nqpc
강완규	nqpc
강완근	nqpc
강완기	nqpc
강완덕	nqpc
강완복	nqpc
강완서	nqpc
강완석	nqpc
강완성	nqpc
강완순	nqpc
강완식	nqpc
강완신	nqpc
강완예	nqpc
강완원	nqpc
강완자	nqpc
강완철	nqpc
강완형	nqpc
강완호	nqpc
강완회	nqpc
강완희	nqpc
강왕구	nqpc
강왕선	nqpc
강왕희	nqpc
강외자	nqpc
강요	ncpa
강요순	nqpc
강요안	nqpc
강요죄	ncn
강용	nqpb
강용관	nqpc
강용구	nqpc
강용국	nqpc
강용규	nqpc
강용근	nqpc
강용기	nqpc
강용길	nqpc
강용대	nqpc
강용덕	nqpc
강용도	nqpc
강용두	nqpc
강용래	nqpc
강용만	nqpc
강용모	nqpc
강용문	nqpc
강용배	nqpc
강용복	nqpc
강용봉	nqpc
강용부	nqpc
강용석	nqpc
강용선	nqpc
강용섭	nqpc
강용성	nqpc
강용수	nqpc
강용숙	nqpc
강용순	nqpc
강용식	nqpc
강용신	nqpc
강용업	nqpc
강용예	nqpc
강용오	nqpc
강용우	nqpc
강용운	nqpc
강용웅	nqpc
강용원	nqpc
강용이	nqpc
강용일	nqpc
강용임	nqpc
강용자	nqpc
강용장	nqpc
강용재	nqpc
강용주	nqpc
강용준	nqpc
강용진	nqpc
강용찬	nqpc
강용천	nqpc
강용철	nqpc
강용칠	nqpc
강용태	nqpc
강용필	nqpc
강용하	nqpc
강용혁	nqpc
강용현	nqpc
강용호	nqpc
강용환	nqpc
강용희	nqpc
강우	nqpb
강우규	nqpc
강우근	nqpc
강우량	ncn
강우석	nqpc
강우선	nqpc
강우성	nqpc
강우순	nqpc
강우식	nqpc
강우신	nqpc
강우영	nqpc
강우원	nqpc
강우조	nqpc
강우종	nqpc
강우진	nqpc
강우철	nqq
강우혁	nqq
강우현	nqpc
강우형	nqpc
강우희	nqpc
강욱	nqpb
강욱순	ncn
강욱희	nqpc
강운구	nqpc
강운규	nqpc
강운기	nqpc
강운길	nqpc
강운석	nqpc
강운수	nqpc
강운숙	nqpc
강운식	nqpc
강운자	nqpc
강운철	nqpc
강운태	nqpc
강운형	nqpc
강운희	nqpc
강웅	nqpb
강웅권	nqpc
강웅규	nqpc
강웅근	nqpc
강웅기	nqpc
강웅범	nqpc
강웅석	nqpc
강웅식	nqpc
강웅원	nqpc
강웅택	nqpc
강원	nqpb
강원구	nqpc
강원권	ncn
강원규	nqpc
강원근	nqpc
강원기	nqpc
강원길	nqpc
강원내촌초등와야분교	ncn
강원대	nqq
강원대학교	nqq
강원도	nqq
강원도일대	ncn
강원도지사	ncn
강원도지역	ncn
강원룡	ncn	nqq
강원매	nqpc
강원모	nqpc
강원병	nqpc
강원산업	nqq
강원석	nqpc
강원선	nqpc
강원섭	nqpc
강원소	nqpc
강원수	nqpc
강원숙	nqpc
강원순	nqpc
강원식	nqpc
강원아	nqpc
강원영	nqpc
강원예	nqpc
강원용	nqq
강원은행	nqq
강원일	nqpc
강원자	nqpc
강원재	nqpc
강원조	nqpc
강원종	nqpc
강원준	nqpc
강원중	nqpc
강원지방	nqq
강원지역	ncn
강원직	nqpc
강원철	nqpc
강원춘	nqpc
강원칠	nqpc
강원태	nqpc
강원택	nqpc
강원포	nqpc
강원혁	nqpc
강원형	nqpc
강원호	nqpc
강원홍	nqpc
강원휘	nqpc
강원희	nqpc
강월광	nqpc
강월난	nqpc
강월란	nqpc
강월분	nqpc
강월석	nqpc
강월선	nqpc
강월숙	nqpc
강월순	nqpc
강월영	nqpc
강위영	nqpc
강위호	nqpc
강유	ncn
강유기	nqpc
강유님	nqpc
강유생	nqpc
강유석	nqpc
강유성	nqpc
강유수	nqpc
강유식	nqpc
강유신	nqpc
강유역	ncn
강유옥	nqpc
강유위	ncn
강유자	nqpc
강유정	nqpc
강유준	nqpc
강유천	nqpc
강유현	nqpc
강윤	nqpb
강윤구	nqpc
강윤규	nqpc
강윤기	nqpc
강윤길	nqpc
강윤모	nqpc
강윤미	nqpc
강윤범	nqpc
강윤병	nqpc
강윤서	nqpc
강윤석	nqpc
강윤선	nqpc
강윤수	nqpc
강윤순	nqpc
강윤식	nqpc
강윤원	nqpc
강윤의	nqpc
강윤이	nqpc
강윤자	nqpc
강윤정	nqpc
강윤종	nqpc
강윤주	nqpc
강윤중	nqpc
강윤진	nqpc
강윤찬	nqpc
강윤철	nqpc
강윤택	nqpc
강윤향	nqpc
강윤현	nqpc
강윤호	nqpc
강윤환	nqpc
강윤희	nqpc
강율모	nqpc
강율예	nqpc
강융희	nqpc
강은경	nqpc
강은교	ncn
강은구	nqpc
강은국	nqpc
강은귀	nqpc
강은규	nqpc
강은모	nqpc
강은미	nqpc
강은서	nqpc
강은석	nqpc
강은선	nqpc
강은섭	nqpc
강은성	nqpc
강은숙	nqpc
강은순	nqpc
강은실	nqpc
강은심	nqpc
강은아	nqpc
강은영	nqpc
강은옥	nqpc
강은완	nqpc
강은용	nqpc
강은자	nqpc
강은정	nqpc
강은주	nqpc
강은진	nqpc
강은철	nqpc
강은택	nqpc
강은형	nqpc
강은호	nqpc
강은희	nqpc
강을규	nqpc
강을만	nqpc
강을상	nqpc
강을선	nqpc
강을수	nqpc
강을순	nqpc
강을식	nqpc
강음전	nqpc
강응구	nqpc
강응례	nqpc
강응석	nqpc
강응순	nqpc
강응준	nqpc
강응철	nqpc
강의	ncpa
강의과목	ncn
강의교안	ncn
강의내용	ncn
강의록	ncn
강의론	ncn
강의명	nqpc
강의부	nqpc
강의석	nqpc
강의선	nqpc
강의성	nqpc
강의순	nqpc
강의시간	ncn
강의식	nqpc
강의신	nqpc
강의실	ncn
강의원	nqpc
강의일정	ncn
강의자	nqpc
강의정보	ncn
강의준	nqpc
강의창	nqpc
강의평가제	ncn
강의형	nqpc
강이구	nqpc
강이규	nqpc
강이석	nqpc
강이섭	nqpc
강이성	nqpc
강이수	nqpc
강이숙	nqpc
강이순	nqpc
강이식	nqpc
강이연	nqpc
강이원	nqpc
강이환	nqpc
강이희	nqpc
강익	nqpb
강익모	nqpc
강익범	nqpc
강익분	nqpc
강익선	nqpc
강익수	nqpc
강익순	nqpc
강익우	nqpc
강익재	nqpc
강익현	nqpc
강익형	nqpc
강익호	nqpc
강인	ncn	ncps
강인경	nqpc
강인구	nqpc
강인국	nqpc
강인권	nqpc
강인규	nqpc
강인근	nqpc
강인기	nqpc
강인달	nqpc
강인덕	nqq
강인모	nqpc
강인목	nqpc
강인배	nqpc
강인범	ncn
강인복	nqpc
강인봉	nqpc
강인빈	nqpc
강인서	nqpc
강인석	nqpc
강인선	nqpc
강인섭	nqq
강인성	nqpc
강인수	nqpc
강인숙	nqpc
강인순	nqpc
강인식	nqpc
강인애	nqpc
강인영	nqpc
강인옥	nqpc
강인용	nqpc
강인원	nqpc
강인자	nqpc
강인종	nqpc
강인주	nqpc
강인준	nqpc
강인중	nqpc
강인찬	nqpc
강인창	nqpc
강인철	nqpc
강인춘	nqpc
강인택	nqpc
강인평	nqpc
강인하	nqpc
강인형	nqpc
강인호	nqpc
강인화	nqpc
강인후	nqpc
강인훈	nqpc
강인희	nqpc
강일	nqpb
강일구	nqpc
강일권	nqpc
강일규	nqpc
강일길	nqpc
강일남	nqpc
강일동	nqpc
강일랑	nqpc
강일례	nqpc
강일모	nqpc
강일문	nqpc
강일민	nqpc
강일병	nqpc
강일봉	nqpc
강일상	nqpc
강일석	nqpc
강일선	nqpc
강일섭	nqpc
강일성	nqpc
강일수	nqpc
강일순	nqpc
강일승	nqpc
강일식	nqpc
강일안	nqpc
강일영	nqpc
강일예	nqpc
강일옥	nqpc
강일용	nqpc
강일웅	nqpc
강일원	nqpc
강일중	nqpc
강일창	nqpc
강일현	nqpc
강일형	nqpc
강일호	nqpc
강일화	nqpc
강일환	nqpc
강일훈	nqpc
강임선	nqpc
강임성	nqpc
강임숙	nqpc
강임순	nqpc
강임옥	nqpc
강임준	nqpc
강임찬	nqpc
강임철	nqpc
강자	ncn
강자갈	ncn
강자영	nqpc
강자용	nqpc
강장관	nqpc
강장구	nqpc
강장규	nqpc
강장근	nqpc
강장기	ncn
강장동물	ncn
강장석	nqpc
강장선	nqpc
강장수	nqpc
강장식	nqpc
강장식품	ncn
강장용	nqpc
강장윤	nqpc
강장제	ncn
강장현	nqpc
강장희	nqpc
강재	ncn
강재관	nqpc
강재구	nqpc
강재규	nqpc
강재근	nqpc
강재길	nqpc
강재남	nqpc
강재덕	nqpc
강재도	nqpc
강재동	nqpc
강재만	nqpc
강재몽	nqpc
강재묵	nqpc
강재민	nqpc
강재복	nqpc
강재봉	nqpc
강재서	nqpc
강재석	nqpc
강재선	nqpc
강재섭	nqpc
강재성	nqpc
강재수	nqpc
강재순	nqpc
강재식	nqpc
강재신	nqpc
강재언	nqpc
강재연	nqpc
강재열	nqpc
강재영	nqpc
강재옥	nqpc
강재용	nqpc
강재욱	nqpc
강재운	nqpc
강재원	nqpc
강재위임	ncpa
강재익	nqpc
강재일	nqpc
강재진	nqpc
강재철	nqpc
강재춘	nqpc
강재판	nqpc
강재학	nqpc
강재헌	nqpc
강재현	nqpc
강재형	nqpc
강재호	nqpc
강재환	nqpc
강재훈	nqpc
강재희	nqpc
강저구	nqq
강적	ncn
강전구	nqpc
강전국	nqpc
강전무	nqpc
강전배	nqpc
강전범	nqpc
강전부품	ncn
강전석	nqpc
강전섭	nqpc
강전성	nqpc
강전세	nqpc
강전수	nqpc
강전숙	nqpc
강전양	nqpc
강전영	nqpc
강전오월	nqpc
강전옥	nqpc
강전왕	nqpc
강전우	nqpc
강전웅	nqpc
강전원	nqpc
강전의	nqpc
강전일	nqpc
강전태	nqpc
강전택	nqpc
강전형	nqpc
강전홍	nqpc
강전환	nqpc
강절도	ncn
강점	ncn	ncpa
강점구	nqpc
강점기	ncn
강점동	nqpc
강점룡	nqpc
강점석	nqpc
강점선	nqpc
강점순	nqpc
강점술	nqpc
강점시기	ncn
강점용	nqpc
강점자	nqpc
강정	ncn
강정관	nqpc
강정교	nqpc
강정구	nqpc
강정귀	nqpc
강정규	nqpc
강정근	nqpc
강정금	nqpc
강정기	nqpc
강정길	nqpc
강정남	nqpc
강정님	nqpc
강정달	nqpc
강정대	nqpc
강정동	nqpc
강정득	nqpc
강정락	nqpc
강정란	nqpc
강정래	nqpc
강정량	nqpc
강정례	nqpc
강정만	nqpc
강정명	nqpc
강정모	nqpc
강정묵	nqpc
강정문	nqpc
강정배	nqpc
강정복	nqpc
강정분	nqpc
강정석	nqpc
강정선	nqpc
강정섭	nqpc
강정수	nqpc
강정숙	nqpc
강정순	nqpc
강정식	nqpc
강정신	nqpc
강정실	nqpc
강정아	nqpc
강정애	nqpc
강정업	nqpc
강정열	nqpc
강정영	nqpc
강정예	nqpc
강정오	nqpc
강정옥	nqpc
강정완	nqpc
강정용	nqpc
강정욱	nqpc
강정웅	nqpc
강정원	nqpc
강정위	nqpc
강정이	nqpc
강정익	nqpc
강정인	nqpc
강정일	nqpc
강정임	nqpc
강정자	nqpc
강정주	nqpc
강정죽	nqpc
강정준	nqpc
강정춘	nqpc
강정탁	nqpc
강정태	nqpc
강정평	nqpc
강정학	nqpc
강정헌	nqpc
강정현	nqpc
강정호	nqpc
강정화	nqpc
강정환	nqpc
강정효	nqpc
강정훈	nqpc
강정흔	nqpc
강정희	nqpc
강제	ncpa
강제격리규정	ncn	ncpa
강제경	nqpc
강제경매	ncn
강제공출	ncpa
강제구인	ncpa
강제구인여부	ncn
강제군	nqpc
강제권력	ncn
강제귀국	ncn
강제규	ncn
강제규정	ncpa
강제급배기방식제품	ncn
강제기능	ncn
강제노동	ncpa
강제노동기간	ncn
강제노동시간	ncn
강제대류식	ncn
강제도선	ncn
강제동원	ncpa
강제력	ncn
강제명령	ncpa
강제모금	ncpa
강제배기	ncpa
강제법칙	ncn
강제병합	ncpa
강제보급	ncpa
강제성	ncn
강제소환	ncn
강제송환	ncpa
강제송환방침	ncn
강제수단	ncn
강제수사	ncpa
강제수용	ncn
강제수용소	ncn
강제숙	nqpc
강제식	nqpc
강제실시권	ncn
강제실시권허여사유	ncn
강제연행	ncpa
강제운동	ncpa
강제원	nqpc
강제인계	ncpa
강제저축	ncpa
강제점령	ncpa
강제조직	ncpa
강제주입	ncpa
강제증산정책	ncn
강제집행	ncpa
강제집행제도	ncn
강제징발	ncpa
강제징병	ncpa
강제징용	ncpa
강제징집	ncpa
강제징집제도	ncn
강제철거	ncpa
강제추방	ncpa
강제출국	ncpa
강제침입	ncpa
강제택	nqpc
강제퇴역	ncpa
강제퇴직	ncpa
강제폐간	ncpa
강제하야	ncpa
강제학	nqpc
강제해체	ncpa
강제행사	ncpa
강제호	nqpc
강제휴가	ncn
강조	ncpa
강조법	ncn
강조부분	ncn
강조영	nqpc
강조점	ncn
강조형태	ncn
강족간	nqpc
강종구	nqpc
강종권	nqpc
강종귀	nqpc
강종규	nqpc
강종대	nqpc
강종두	nqpc
강종득	nqpc
강종률	nqpc
강종모	nqpc
강종묵	nqpc
강종문	nqpc
강종미	nqpc
강종삼	nqpc
강종서	nqpc
강종석	nqpc
강종선	nqpc
강종섭	nqpc
강종성	nqpc
강종세	nqpc
강종수	nqpc
강종숙	nqpc
강종식	nqpc
강종신	nqpc
강종실	nqpc
강종애	nqpc
강종억	nqpc
강종연	nqpc
강종열	nqpc
강종오	nqpc
강종완	nqpc
강종우	nqpc
강종욱	nqpc
강종원	nqpc
강종일	nqpc
강종정	nqpc
강종철	nqpc
강종칠	nqpc
강종태	nqpc
강종하	nqpc
강종학	nqpc
강종한	nqpc
강종해	nqpc
강종현	nqpc
강종호	nqpc
강종환	nqpc
강종후	nqpc
강종훈	nqpc
강종희	nqpc
강좌	ncn
강좌웅	nqpc
강좌원	nqpc
강좌재원	ncn
강주	ncn
강주남	nqpc
강주병	nqpc
강주봉	nqpc
강주상	nqpc
강주석	nqpc
강주섭	nqpc
강주성	nqpc
강주순	nqpc
강주식	nqpc
강주영	nqpc
강주옥	nqpc
강주원	nqpc
강주일	nqpc
강주하	nqpc
강주혁	nqpc
강주현	nqpc
강주형	nqpc
강주호	nqpc
강주환	nqpc
강주희	nqpc
강죽부	nqpc
강준	nqpb
강준구	nqpc
강준규	nqpc
강준근	nqpc
강준기	nqpc
강준만	nqpc
강준모	nqpc
강준묵	nqpc
강준배	nqpc
강준복	nqpc
강준봉	nqpc
강준부	nqpc
강준상	nqpc
강준서	nqpc
강준석	nqpc
강준선	nqpc
강준수	nqpc
강준식	nqpc
강준양	nqpc
강준영	nqpc
강준오	nqpc
강준옥	nqpc
강준우	nqpc
강준이	nqpc
강준익	nqpc
강준철	nqpc
강준택	nqpc
강준현	nqpc
강준형	nqpc
강준호	nqpc
강준홍	nqpc
강준화	nqpc
강준희	nqpc
강줄기	ncn
강중광	nqpc
강중구	nqpc
강중규	nqpc
강중근	nqpc
강중령	nqpc
강중모	nqpc
강중배	nqpc
강중석	nqpc
강중섭	nqpc
강중식	nqpc
강중우	nqq
강중운	nqpc
강중원	nqpc
강중임	nqpc
강중택	nqpc
강중현	nqpc
강중호	nqpc
강증식	nqpc
강지균	nqpc
강지민	nqpc
강지석	nqpc
강지선	nqpc
강지성	nqpc
강지숙	nqpc
강지식	nqpc
강지연	nqpc
강지웅	nqpc
강지은	nqpc
강지중	nqpc
강지현	nqpc
강지호	nqpc
강지훈	nqpc
강직	ncps
강직병	nqpc
강직원	nqpc
강진	ncn	nqpb
강진구	nqpc
강진군	nqq
강진권	nqpc
강진규	nqpc
강진근	nqpc
강진기	nqpc
강진련	nqpc
강진모	nqpc
강진백	nqpc
강진복	nqpc
강진산	nqpc
강진석	nqpc
강진선	nqpc
강진수	nqpc
강진숙	nqpc
강진순	nqpc
강진술	nqpc
강진식	nqpc
강진암	nqpc
강진엽	nqpc
강진영	nqpc
강진용	nqpc
강진욱	nqpc
강진원	nqpc
강진태	nqpc
강진학	nqpc
강진형	nqpc
강진호	nqpc
강진홍	nqpc
강진화	nqpc
강진환	nqpc
강진희	nqpc
강짜	ncn
강차석	nqq
강차수	nqpc
강차식	nqpc
강차이	nqpc
강차중	nqpc
강찬구	nqpc
강찬규	nqpc
강찬석	nqpc
강찬수	nqpc
강찬순	nqpc
강찬식	nqpc
강찬영	nqpc
강찬용	nqpc
강찬일	nqpc
강찬혁	nqq
강찬호	nqpc
강찬희	nqpc
강창경	nqpc
강창곤	nqpc
강창구	nqpc
강창국	nqpc
강창귀	nqpc
강창규	nqpc
강창근	nqpc
강창기	nqpc
강창길	nqpc
강창남	nqpc
강창달	ncn
강창대	nqpc
강창덕	nqpc
강창모	nqpc
강창민	nqpc
강창백	nqpc
강창복	nqpc
강창석	nqpc
강창선	nqpc
강창섭	nqpc
강창성	nqpc
강창수	nqpc
강창숙	nqpc
강창순	nqpc
강창식	nqpc
강창신	nqpc
강창언	nqpc
강창열	nqpc
강창완	nqpc
강창용	nqpc
강창우	nqpc
강창원	nqpc
강창일	nqpc
강창임	nqpc
강창주	nqpc
강창준	nqpc
강창현	nqpc
강창호	nqpc
강창환	nqpc
강창훈	nqpc
강창희	nqpc
강채구	nqpc
강채규	nqpc
강채서	nqpc
강채영	nqpc
강채운	nqpc
강채원	nqpc
강채홍	nqpc
강채희	nqpc
강처운	nqpc
강처원	nqpc
강척기	nqpc
강천	nqq
강천구	nqpc
강천규	nqpc
강천만	nqpc
강천모	nqpc
강천배	nqpc
강천복	nqpc
강천상	nqpc
강천석	nqpc
강천섭	nqpc
강천수	nqpc
강천식	nqpc
강천영	nqpc
강천옥	nqpc
강천호	nqpc
강철	ncn
강철골조	ncn
강철구	nqpc
강철규	nqpc
강철근	nqpc
강철기둥	ncn
강철동	nqpc
강철모	nqpc
강철미학	ncn
강철뼈다귀	ncn
강철선	nqq
강철성	nqpc
강철수	nqpc
강철숙	nqpc
강철순	nqpc
강철식	nqpc
강철신	nqpc
강철오	nqpc
강철용	nqpc
강철웅	nqpc
강철원	nqpc
강철제	ncn
강철종	nqpc
강철주	nqpc
강철중	nqpc
강철학	nqpc
강철형	nqpc
강철호	nqpc
강철화	nqpc
강철환	nqpc
강철훈	nqpc
강철희	nqpc
강청	ncpa
강청길	nqpc
강청식	nqpc
강청일	nqpc
강청일당	ncn
강청자	nqpc
강청희	nqpc
강촌	ncn
강총각	nqpc
강추금	nqq
강추위	ncn
강춘갑	nqpc
강춘곤	nqpc
강춘광	nqpc
강춘구	nqpc
강춘권	nqpc
강춘규	nqpc
강춘근	nqpc
강춘금	nqpc
강춘기	nqpc
강춘길	nqpc
강춘녀	nqpc
강춘란	nqpc
강춘만	nqpc
강춘모	nqpc
강춘보	nqpc
강춘봉	nqpc
강춘산	nqpc
강춘석	nqpc
강춘선	nqpc
강춘성	nqpc
강춘식	nqpc
강춘실	nqpc
강춘옥	nqpc
강춘운	nqpc
강춘원	nqpc
강춘일	nqpc
강춘자	nqpc
강춘전	nqpc
강춘지	nqpc
강춘진	nqpc
강춘하	nqpc
강춘형	nqpc
강춘호	nqpc
강춘희	nqpc
강충구	nqpc
강충규	nqpc
강충남	ncn
강충랑	nqpc
강충만	nqpc
강충모	nqpc
강충석	nqpc
강충순	nqpc
강충식	nqpc
강충신	nqpc
강충열	nqpc
강충원	nqpc
강충현	nqpc
강충화	nqpc
강충희	nqpc
강취	ncpa
강치곡	nqpc
강치순	nqpc
강치식	nqpc
강치우	nqpc
강치원	nqpc
강치체계	ncn
강칠섭	nqpc
강칠성	nqpc
강칠용	nqpc
강타	ncn	ncpa
강타자	ncn
강탁	nqq
강탈	ncpa
강탈사건	ncn
강태건	nqpc
강태경	nqpc
강태공	nqq
강태관	nqpc
강태광	nqpc
강태구	nqpc
강태국	nqpc
강태군	nqpc
강태권	nqpc
강태규	nqpc
강태근	nqpc
강태기	nqpc
강태길	nqpc
강태농	nqpc
강태님	nqpc
강태동	nqpc
강태룡	nqpc
강태만	nqpc
강태명	nqpc
강태모	nqpc
강태묵	nqpc
강태문	nqpc
강태미	nqpc
강태복	nqpc
강태봉	nqpc
강태분	nqpc
강태서	nqpc
강태석	nqpc
강태선	nqpc
강태섭	nqpc
강태성	nqpc
강태수	nqpc
강태숙	nqpc
강태순	nqpc
강태술	nqpc
강태식	nqpc
강태신	nqpc
강태양	nqpc
강태언	nqpc
강태연	nqpc
강태열	nqpc
강태영	nqpc
강태예	nqpc
강태옥	nqpc
강태용	nqpc
강태우	nqpc
강태욱	nqpc
강태운	nqpc
강태웅	nqpc
강태원	nqpc
강태유	nqpc
강태윤	nqpc
강태은	nqpc
강태이	nqpc
강태익	nqpc
강태인	nqpc
강태일	nqpc
강태자	nqpc
강태정	nqpc
강태종	nqpc
강태주	nqpc
강태준	nqpc
강태중	nqpc
강태진	nqpc
강태창	nqpc
강태철	nqpc
강태춘	nqpc
강태평	nqpc
강태하	nqpc
강태학	nqpc
강태헌	nqpc
강태혁	nqpc
강태현	nqpc
강태형	nqpc
강태호	nqpc
강태홍	nqpc
강태화	nqpc
강태환	nqpc
강태훈	nqpc
강태희	nqpc
강택구	nqpc
강택민	ncn
강택서	nqpc
강택석	nqpc
강택성	nqpc
강택현	nqpc
강택희	nqpc
강토	ncn
강통원	nqpc
강판	ncn
강판구	nqpc
강판석	nqpc
강판쇠	nqpc
강판식	nqpc
강판오	nqpc
강판윤	nqpc
강판주	nqpc
강판중	nqpc
강팔봉	nqpc
강팔성	nqpc
강퍅	ncps
강평	ncpa
강평구	nqpc
강평규	nqpc
강평분	nqpc
강평수	nqpc
강평순	nqpc
강평의	nqpc
강포	ncps
강폭	ncn
강풍	ncn
강풍경고	ncpa
강풍규	nqpc
강풍식	nqpc
강풍용	nqpc
강풍자	nqpc
강풍호	nqpc
강필구	nqpc
강필규	nqpc
강필대	nqpc
강필두	nqpc
강필모	nqpc
강필석	nqpc
강필선	nqpc
강필순	nqpc
강필식	nqpc
강필신	nqpc
강필우	nqpc
강필원	nqpc
강필종	nqpc
강필중	nqpc
강필진	nqpc
강필형	nqpc
강필훈	nqpc
강하	ncpa	paa
강하류	ncn
강하석	nqpc
강하수	nqpc
강하식	nqpc
강하영	nqpc
강하왕	nqq
강하용	nqpc
강학구	nqpc
강학규	nqpc
강학근	nqpc
강학기	nqpc
강학래	nqpc
강학림	nqpc
강학모	nqpc
강학봉	nqpc
강학석	nqpc
강학선	nqpc
강학수	nqpc
강학순	nqpc
강학식	nqpc
강학자	nqpc
강한갑	nqpc
강한구	nqpc
강한규	nqpc
강한기	nqpc
강한길	nqpc
강한덕	nqpc
강한두	nqpc
강한모	nqpc
강한봉	nqpc
강한석	nqpc
강한섭	nqpc
강한수	nqpc
강한술	nqpc
강한양	nqpc
강한영	nqpc
강한종	nqpc
강한준	nqpc
강한중	nqpc
강한형	nqpc
강한호	nqpc
강항주	nqpc
강해	ncpa
강해경	nqpc
강해구	nqpc
강해달	nqpc
강해련	nqpc
강해룡	nqpc
강해만	nqpc
강해봉	nqpc
강해산	nqpc
강해선	nqpc
강해섭	nqpc
강해성	nqpc
강해숙	nqpc
강해식	nqpc
강해열	nqpc
강해완	nqpc
강해용	nqpc
강해운	nqpc
강해원	nqpc
강해인	nqpc
강해전	nqpc
강해지	pvg
강해희	nqpc
강핵심	ncn
강행	ncpa
강행군	ncpa
강행길	nqpc
강행방침	ncn
강행복	nqpc
강행숙	nqpc
강행여부	ncn
강행원	nqpc
강행처리	ncn	ncpa
강행통과	ncpa
강향규	nqpc
강향석	nqpc
강향숙	nqpc
강향순	nqpc
강향식	nqpc
강향예	nqpc
강향월	nqpc
강향자	nqpc
강향진	nqpc
강향희	nqpc
강헌	ncn
강헌구	nqpc
강헌국	nqpc
강헌규	nqpc
강헌만	nqpc
강헌모	nqpc
강헌미	nqpc
강헌석	nqpc
강헌수	nqpc
강헌식	nqpc
강헌철	nqpc
강헌희	nqpc
강혁	ncn
강혁권	nqpc
강혁기	nqpc
강혁종	nqpc
강현	ncn
강현경	nqpc
강현관	nqpc
강현구	nqpc
강현국	nqpc
강현규	nqpc
강현근	nqpc
강현기	nqpc
강현길	nqpc
강현대	nqpc
강현덕	nqpc
강현두	nqpc
강현례	nqpc
강현만	nqpc
강현명	nqpc
강현모	nqpc
강현미	nqpc
강현복	nqpc
강현봉	nqpc
강현상	nqpc
강현서	nqpc
강현석	nqpc
강현선	nqpc
강현성	nqpc
강현수	nqpc
강현숙	nqpc
강현순	nqpc
강현식	nqpc
강현실	nqpc
강현옥	nqpc
강현용	nqpc
강현욱	nqpc
강현자	nqpc
강현정	nqpc
강현조	nqpc
강현주	nqpc
강현준	nqpc
강현진	nqpc
강현창	nqpc
강현철	nqpc
강현태	nqpc
강현필	nqpc
강현희	nqpc
강형관	nqpc
강형구	nqpc
강형국	nqpc
강형권	nqpc
강형규	nqpc
강형근	nqpc
강형기	nqpc
강형길	nqpc
강형대	nqpc
강형덕	nqpc
강형득	nqpc
강형래	nqpc
강형만	nqpc
강형명	nqpc
강형모	nqpc
강형민	nqpc
강형배	nqpc
강형복	nqpc
강형봉	nqpc
강형석	nqpc
강형섭	nqpc
강형수	nqpc
강형숙	nqpc
강형순	nqpc
강형식	nqpc
강형아	nqpc
강형열	nqpc
강형우	nqpc
강형원	nqpc
강형윤	nqpc
강형일	nqpc
강형자	nqpc
강형전	nqpc
강형종	nqpc
강형주	nqpc
강형준	nqpc
강형지	nqpc
강형진	nqpc
강형채	nqpc
강혜경	nqpc
강혜근	nqpc
강혜련	nqpc
강혜명	nqpc
강혜미	ncn
강혜민	nqpc
강혜숙	nqpc
강혜순	nqpc
강혜식	nqpc
강혜자	nqpc
강혜정	nqpc
강혜중	nqpc
강혜진	nqpc
강호	ncn	nqpb
강호경	nqpc
강호계	nqpc
강호관	nqpc
강호구	nqpc
강호국	nqpc
강호규	nqpc
강호근	nqpc
강호금	nqpc
강호길	nqpc
강호녀	nqpc
강호덕	nqpc
강호동	ncn	nqq
강호률	nqpc
강호모	nqpc
강호범	nqpc
강호병	nqpc
강호삼	nqpc
강호석	nqpc
강호선	nqpc
강호성	nqpc
강호수	nqpc
강호숙	nqpc
강호순	nqpc
강호식	nqpc
강호신	nqpc
강호안	nqpc
강호양	nqpc
강호영	nqpc
강호완	nqpc
강호웅	nqpc
강호원	nqpc
강호율	nqpc
강호익	nqpc
강호일	nqpc
강호정	nqpc
강호준	nqpc
강호진	nqpc
강호철	nqpc
강호택	nqpc
강호현	nqpc
강홍구	nqpc
강홍규	nqpc
강홍근	nqpc
강홍남	nqpc
강홍대	nqpc
강홍두	nqpc
강홍렬	nqpc
강홍례	nqpc
강홍립	nqq
강홍모	nqpc
강홍복	nqpc
강홍석	nqpc
강홍선	nqpc
강홍수	nqpc
강홍순	nqpc
강홍술	nqpc
강홍식	nqpc
강홍열	nqpc
강홍욱	nqpc
강홍일	nqpc
강홍자	nqpc
강홍주	nqpc
강홍태	nqpc
강화	ncpa	nqq
강화갑	ncn
강화계획	ncn	ncpa
강화군	nqq
강화규정	ncn
강화기	ncn
강화도	nqq
강화도조약	ncpa
강화문제	ncn
강화방안	ncn
강화방침	ncn
강화상태	ncn
강화선	nqpc
강화성	nqq
강화수	nqpc
강화숙	nqpc
강화순	nqpc
강화식	nqpc
강화영	nqpc
강화운동	ncpa
강화원	nqpc
강화을	ncn
강화읍	nqq
강화읍성	ncn
강화이론	ncn
강화자	nqpc
강화작업	ncpa
강화작용	ncpa
강화전략	ncn
강화조건	ncn
강화조약	ncn
강화조치	ncpa
강화중	nqpc
강화지구	ncn
강화지시	ncpa
강화책	ncn
강화태	nqpc
강화포수	ncn
강화학파	ncn
강화해협	ncn
강화현	nqpc
강화현상	ncn
강화회담	ncpa
강환	nqpb
강환경	nqpc
강환구	nqpc
강환국	nqpc
강환기	nqpc
강환명	nqpc
강환무	nqpc
강환문	nqpc
강환봉	nqpc
강환분	nqpc
강환비	nqpc
강환석	nqpc
강환선	nqpc
강환섭	nqpc
강환성	nqpc
강환순	nqpc
강환승	nqpc
강환식	nqpc
강환신	nqpc
강환영	nqpc
강환용	nqpc
강환욱	nqpc
강환익	nqpc
강환일	nqpc
강환정	nqpc
강환조	nqpc
강환주	nqpc
강환준	nqpc
강환찬	nqpc
강환창	nqpc
강환철	nqpc
강환택	nqpc
강환표	nqpc
강환학	nqpc
강환회	nqpc
강활모	nqpc
강활성	nqpc
강황주	nqpc
강회	ncpa
강효규	nqpc
강효백	nqpc
강효상	ncn
강효석	nqpc
강효선	nqpc
강효섭	nqpc
강효성	nqpc
강효숙	nqpc
강효순	nqpc
강효열	nqpc
강효영	nqpc
강효원	nqpc
강효일	nqpc
강효정	nqpc
강효종	nqpc
강효진	nqpc
강효화	nqpc
강효희	nqpc
강후	nqq
강후남	nqpc
강후식	nqpc
강훈	nqpb
강훈구	nqpc
강훈규	nqpc
강훈덕	nqpc
강훈식	nqpc
강휴선	nqpc
강흐름	ncn
강흔구	nqpc
강흠근	nqpc
강흥구	nqpc
강흥권	nqpc
강흥규	nqpc
강흥모	nqpc
강흥복	nqpc
강흥석	nqpc
강흥선	nqpc
강흥섭	nqpc
강흥수	nqpc
강흥순	nqpc
강흥식	nqpc
강흥용	nqpc
강흥원	nqpc
강흥진	nqpc
강흥환	nqpc
강희	nqpb
강희각	nqpc
강희갑	nqpc
강희걸	nqpc
강희경	nqpc
강희곤	nqpc
강희관	nqpc
강희광	nqpc
강희교	nqpc
강희구	nqpc
강희국	nqpc
강희군	nqpc
강희권	nqpc
강희규	nqpc
강희균	nqpc
강희근	nqpc
강희길	nqpc
강희남	nqpc
강희님	nqpc
강희달	nqpc
강희대	nqpc
강희덕	nqpc
강희도	nqpc
강희돈	nqpc
강희동	nqpc
강희두	nqpc
강희란	nqpc
강희룡	nqpc
강희만	nqpc
강희면	nqpc
강희명	nqpc
강희목	nqpc
강희무	nqpc
강희문	nqpc
강희민	nqpc
강희방	nqpc
강희배	nqpc
강희백	nqpc
강희범	nqpc
강희복	nqpc
강희봉	nqpc
강희분	nqpc
강희붕	nqpc
강희빈	nqpc
강희산	nqpc
강희삼	nqpc
강희상	nqpc
강희생	nqpc
강희석	nqpc
강희선	nqpc
강희설	nqpc
강희섭	nqpc
강희성	nqpc
강희세	nqpc
강희송	nqpc
강희수	nqpc
강희숙	nqpc
강희순	nqpc
강희승	nqpc
강희식	nqpc
강희양	nqpc
강희여	nqpc
강희연	nqpc
강희열	nqpc
강희영	nqpc
강희옥	nqpc
강희완	nqpc
강희용	nqpc
강희우	nqpc
강희욱	nqpc
강희운	nqpc
강희웅	nqpc
강희원	nqpc
강희월	nqpc
강희윤	nqpc
강희익	nqpc
강희인	nqpc
강희일	nqpc
강희임	nqpc
강희자	nqpc
강희재	nqpc
강희정	nqpc
강희조	nqpc
강희종	nqpc
강희주	nqpc
강희준	nqpc
강희중	nqpc
강희진	nqpc
강희찬	nqpc
강희창	nqpc
강희천	nqpc
강희철	nqpc
강희춘	nqpc
강희태	nqpc
강희택	nqpc
강희팔	nqpc
강희평	nqpc
강희풍	nqpc
강희향	nqpc
강희형	nqpc
강희환	nqpc
강희훈	nqpc
갖	paa	pvg
갖가지	mma	ncn
갖가지로	mag
갖다놓	pvg
갖다버리	pvg
갖다붙이	pvg
갖다주	pvg
갖옷	ncn
갖추	pvg
갖추어지	pvg
갖춰지	pvg
같	paa	px	xsmn
같아지	pvg
같은기간	ncn
같은기간대비	ncn
같이	jca	mag
같이살	pvg
같이하	pvg
갚	pvg
개	nbu	ncn	pvg
개가	ncn
개각	ncn
개각설	ncn
개각충	ncn
개간	ncpa
개간사업	ncn
개간용수	ncpa
개강	ncpa
개같은	ncn
개개	ncn
개개류	ncn
개개발부문	ncn
개개요소	ncn
개개원칙	ncn
개개인	ncn
개개조치	ncpa
개갱	ncpa
개건	ncn
개건물	ncn
개건상량문	ncn
개경	nqq
개고	ncpa
개고개	nqq
개고기	ncn
개고령	nqq
개골산	nqq
개골짜기	nqq
개골창	ncn
개과천선	ncpa
개관	ncn	ncpa
개관기념	ncpa
개관보도	ncpa
개관시간	ncn
개관식	ncn
개관현실	ncn
개괄	ncpa
개괄적	ncn
개교	ncpa
개교기념식	ncn
개교회	ncn
개구	ncn
개구녕	ncn
개구리	ncn
개구리떼	ncn
개구리밥	ncn
개구리알	ncn
개구리참외	ncn
개구부	ncn
개구분비	ncn
개구신	ncn
개구장이	ncn
개구쟁이	ncn
개국	ncpa
개국공신	ncn
개국방문	ncpa
개국성조	ncn
개국시기	ncn
개국신화	ncn
개국준비	ncpa
개국체제	ncn
개권	ncpa
개귀신	ncn
개그	ncn
개그맨	ncn
개그우먼	ncn
개그프로그램	ncn
개근	ncpa
개근상	ncn
개금	ncpa
개기업	nbu
개기일식	ncn
개꽃	ncn
개꿈	ncn
개나리	ncn
개나리꽃	ncn
개나리나무	ncn
개나리잎	ncn
개년	nbu
개념	ncn
개념구성	ncpa
개념구조	ncn
개념규정	ncn	ncpa
개념도	ncn
개념도설명회	ncn
개념도입	ncpa
개념론	ncn
개념망	ncn
개념분열	ncpa
개념사이	ncn
개념상	ncn
개념설계	ncpa
개념설정	ncpa
개념성	ncn
개념쌍	ncn
개념암기	ncpa
개념요소	ncn
개념위주	ncn
개념이해	ncpa
개념자체	ncn
개념작용	ncpa
개념접근	ncpa
개념정리	ncpa
개념정립	ncpa
개념정의	ncn
개념정의방식	ncn
개념중심교육	ncpa
개념지시	ncpa
개념체계	ncn
개념체제	ncn
개념판단	ncpa
개념하	ncn
개념형성	ncpa
개념혼동	ncpa
개노릇	ncn
개놈	ncn
개다리소반	ncn
개당	mag	ncn
개대회	nbu
개도	ncpa
개도국	ncn
개동	nbu
개돼지	ncn
개떡	ncn
개떼	ncn
개똥	ncn
개똥나무	ncn
개똥밭	ncn
개똥벌레	ncn
개똥아	ncn
개략	ncpa
개략도	ncn
개량	ncpa
개량결정	ncn
개량메주	ncn
개량수정주의	ncn
개량작업	ncpa
개량종	ncn
개량주의	ncn
개량주의자	ncn
개량판	ncn
개량형기종	ncn
개런티	ncn
개로	ncpa
개로왕	nqq
개론	ncpa
개리스	nqpc
개리스에반스	nqpc
개리스에번스	nqpc
개리슨	ncn
개리지	ncn
개마	nqq
개마고원	ncn
개막	ncpa
개막경기	ncn
개막식	ncn
개막예정	ncpa
개막일	ncn
개막작품	ncn
개막전	ncn
개막총회	ncn
개망신	ncn	ncpa
개머리판	ncn
개면	ncpa
개면프로젝트	ncn
개명	ncpa
개명상	ncn
개명식	ncn
개목	ncn
개미	ncn
개미구멍	ncn
개미군단	ncn
개미귀신	ncn
개미떼	ncn
개미목숨	ncn
개미집	ncn
개미집단	ncn
개발	ncn	ncpa
개발가능	ncn	ncps
개발가능성	ncn
개발거점	ncn
개발건	ncn
개발격차	ncn
개발결과	ncn
개발경쟁	ncpa
개발경제	ncn
개발경험	ncpa
개발계획	ncpa
개발계획서	ncn
개발공급	ncpa
개발공사	ncn	ncpa
개발공사측	ncn
개발과정	ncn
개발과제	ncn
개발관련	ncpa
개발교육	ncpa
개발구상	ncpa
개발국가	ncn
개발국산품	ncn
개발규제지구	ncn
개발기간	ncn
개발기금	ncn
개발기능	ncn
개발기본계획	ncn	ncpa
개발기술	ncn
개발내용	ncn
개발노력	ncpa
개발능력	ncpa
개발단계	ncn
개발담당부서	ncn
개발당시	ncn
개발도상	ncn
개발도상국	ncn
개발도상국가	ncn
개발도상국가군	ncn
개발도상국사회	ncn
개발독재	ncpa
개발동기	ncn
개발동향	ncn
개발력	ncn
개발모델	ncn
개발모체	ncn
개발목적	ncn
개발목표	ncn
개발방식	ncn
개발방안	ncn
개발방향	ncn
개발배경	ncn
개발법	ncn
개발부담	ncpa
개발부담금	ncn
개발부문	ncn
개발부서	ncn
개발부장	ncn
개발부처	ncn
개발부품사용	ncpa
개발분야	ncn
개발분위기	ncn
개발붐	ncn
개발비	ncn
개발비기준	ncn
개발비부담	ncpa
개발비분담	ncpa
개발비용	ncn
개발비중	ncn
개발사	ncn
개발사실	ncn
개발사업	ncn
개발사업계획안	ncn
개발사업과정	ncpa
개발사업부	ncn
개발사업비	ncn
개발상태	ncn
개발성장	ncpa
개발센터	ncn
개발속도	ncn
개발수요	ncn
개발수익	ncpa
개발수출	ncpa
개발시	ncn
개발시간	ncn
개발시대	ncn
개발시판	ncpa
개발시험	ncpa
개발신제품	ncn
개발신탁	ncn
개발실	ncn
개발실장	ncn
개발실적	ncn
개발실패	ncpa
개발실험	ncn	ncpa
개발업	ncn
개발업무	ncn
개발업체	ncn
개발업체관계자	ncn
개발여력	ncn
개발여부	ncn
개발연구	ncpa
개발연구소	ncn
개발연구실	ncn
개발연구실장	ncn
개발예산	ncpa
개발예정지	ncn
개발예정지구	ncn
개발예정지역	ncn
개발완료	ncpa
개발완료시점	ncn
개발요원	ncpa
개발용역업체	ncn
개발용역회사	ncn
개발운동	ncpa
개발움직임	ncn
개발원	ncn
개발원가절감	ncpa
개발원장	ncn
개발위원회	ncn
개발유도권역	ncn
개발의뢰	ncpa
개발의욕	ncn
개발의의	ncn
개발이익	ncn
개발인력	ncn
개발인력부족	ncpa
개발인원	ncn
개발일정	ncn
개발자	ncn
개발자금	ncn
개발자금규모	ncn
개발자금지원	ncpa
개발작업	ncpa
개발잠재력	ncn
개발장비	ncn
개발전략	ncn
개발전문업체	ncn
개발전문인력	ncn
개발정보	ncn
개발정신	ncn
개발정책	ncn
개발제품	ncn
개발제한	ncn	ncpa
개발제한구역	ncn
개발제한지역	ncn
개발주관기관	ncn
개발주력	ncpa
개발주의	ncn
개발준비금	ncn
개발중단조치	ncpa
개발지	ncn
개발지구	ncn
개발지역	ncn
개발지원	ncpa
개발지원금	ncn
개발진행정도	ncn
개발차원	ncn
개발착수	ncpa
개발참여업체	ncn
개발채택시험	ncpa
개발체계	ncn
개발체제	ncn
개발체제구축	ncpa
개발초점	ncn
개발촉진법	ncn
개발촉진지구	ncn
개발촉진지구대상	ncn
개발최종연도	ncn
개발추세	ncn
개발추진	ncpa
개발코드명	ncn
개발투기	ncpa
개발투자	ncpa
개발투자비	ncn
개발툴	ncn
개발팀	ncn
개발품	ncn
개발품양산	ncn
개발프로젝트	ncn
개발향상	ncpa
개발현황	ncn
개발협력자금	ncn
개발협상	ncpa
개발협약서	ncn
개발형태	ncn
개발환경	ncn
개발활동	ncpa
개발회사	ncn
개발회사측	ncn
개발회의	ncpa
개발후	ncn
개방	ncpa
개방경제	ncn
개방경제화	ncn
개방계획	ncn
개방구획	ncpa
개방노력	ncpa
개방노선	ncn
개방농정	ncn
개방대	ncn
개방대상	ncn
개방대책	ncn
개방대학	ncn
개방문제	ncn
개방반대	ncpa
개방방식	ncn
개방불가	ncn
개방사상	ncn
개방사회	ncn
개방성	ncn
개방속도	ncn
개방수용	ncpa
개방수준	ncn
개방시	ncn
개방시기	ncn
개방시대	ncn
개방시대의	ncn
개방시스템	ncn
개방식	ncn
개방안	ncn
개방압력	ncn
개방약속	ncpa
개방예측	ncpa
개방유예	ncpa
개방이후	ncn
개방일정	ncn
개방전망	ncn
개방정책	ncn
개방제한	ncpa
개방조치	ncpa
개방지지파	ncn
개방집단	ncn
개방체계	ncn
개방체제	ncn
개방폭	ncn
개방피해	ncn
개방혁명	ncpa
개방협상	ncn
개방형	ncn
개방형구조	ncn
개방형시스팀	ncn
개방형시스팀사	ncn
개방화	ncn
개방화시대	ncn
개법	ncpa
개벼룩	ncn
개벽	ncpa	nqq
개벽사상	ncn
개벽시대	ncn
개벽지	nqq
개변	ncn
개별	ncn
개별가계	ncn
개별가족	ncn
개별가치	ncn
개별각료회의	ncpa
개별건물	ncn
개별경제주체	ncn
개별공시지가	ncn
개별공장	ncn
개별과학	ncn
개별구성원	ncn
개별국가	ncn
개별그룹	ncn
개별기계	ncn
개별기술	ncn
개별기업	ncn
개별노동	ncpa
개별노동자	ncn
개별논문	ncn
개별농가	ncn
개별단체	ncn
개별대응	ncpa
개별리모컨기능	ncn
개별마을	ncn
개별묘사	ncpa
개별반도체	ncn
개별반도체유통업체	ncn
개별반응	ncpa
개별방식	ncn
개별범주	ncn
개별보장	ncpa
개별보장국	ncn
개별분산성	ncn
개별분업	ncpa
개별브랜드	ncn
개별사건	ncn
개별사례	ncn
개별사업	ncn
개별산업	ncn
개별산업육성법	ncn
개별상담	ncpa
개별상품	ncn
개별상황	ncn
개별생산자	ncn
개별선호	ncpa
개별성	ncn
개별센서	ncn
개별소비자	ncn
개별소자	ncn
개별소자단계	ncn
개별수요	ncn
개별시민	ncn
개별시장	ncn
개별언어	ncn
개별업체	ncn
개별요소	ncn
개별원칙	ncn
개별유형	ncn
개별은행	ncn
개별인가	ncpa
개별자	ncn
개별자본	ncn
개별자본가	ncn
개별자본축적	ncpa
개별작품	ncn
개별작품심의	ncpa
개별재료	ncn
개별전체판매수량	ncn
개별접속형	ncn
개별접촉	ncpa
개별정상외교	ncn
개별제어	ncpa
개별제어시스팀	ncn
개별종교	ncn
개별주식	ncn
개별지도	ncpa
개별펀드	ncn
개별행동	ncpa
개별현상	ncn
개별협상	ncpa
개별협약	ncpa
개별형시스팀	ncn
개별화	ncpa
개별화해	ncpa
개보수	ncn
개복	ncpa
개봉	ncpa
개봉관	ncn
개봉교차	ncpa
개봉교차로	ncn
개봉작	ncn
개봉작품	ncn
개봉지하차도	ncn
개부문	nbu
개비	nbu	ncn	ncpa
개비행장	ncn
개사	ncpa
개사가	ncn
개사곡	ncn
개산	ncpa
개살구	ncn
개살구나무	ncn
개상	ncn
개상목	ncn
개새끼	ii	ncn
개새편	nqq
개서	ncpa
개서나무	ncn
개석	ncn
개선	ncpa
개선가	ncn
개선거구	ncn
개선결과	ncn
개선군	ncn
개선기술혁신	ncpa
개선내용	ncn
개선대책	ncn
개선명령	ncpa
개선모델	ncn
개선문	ncn
개선방법	ncn
개선방안	ncn
개선방향	ncn
개선불가능	ncpa
개선사례	ncn
개선사업	ncn
개선안	ncn
개선요구	ncpa
개선의지	ncpa
개선작업	ncn	ncpa
개선장군	ncn
개선전략	ncn
개선점	ncn
개선정책	ncn
개선조치	ncpa
개선책	ncn
개선활동	ncpa
개선효과	ncn
개설	ncpa
개설계획	ncpa
개설과목	ncn
개설기준	ncpa
개설당시	ncn
개설서	ncn
개설식	ncn
개설신청	ncpa
개설운동	ncpa
개설운용	ncpa
개설이유	ncn
개설자금	ncn
개설준비위원장	ncn
개설허가	ncpa
개설후	ncn
개성	ncn	nqq
개성공급	ncpa
개성기술	ncn
개성기준	ncpa
개성닭젓국	ncn
개성석경	ncn
개성지방	ncn
개성창출	ncpa
개성화	ncn
개소	nbu	ncpa
개소리	ncn
개솔린	ncn
개솔린가격	ncn
개솔린엔진	ncn
개수	ncn	ncpa
개수임금제도	ncn
개수작	ncpa
개술	ncpa
개스	ncn
개스가전유통사업	ncn
개스개폐기	ncn
개스개폐기시장	ncn
개스개폐기업계	ncn
개스개폐기업체	ncn
개스관	ncn
개스관배관공사	ncn
개스기기	ncn
개스기기전문업체	ncn
개스등	ncn
개스라이터	ncn
개스레인지	ncn
개스미터	ncn
개스방전기술	ncn
개스방전램프	ncn
개스보일러	ncn
개스보일러사업	ncn
개스보일러생산라인	ncn
개스보일러자동측정장비	ncn
개스센서	ncn
개스센서생산업체	ncn
개스소비량	ncn
개스스토브	ncn
개스시장	ncn
개스연결호스	ncn
개스오븐	ncn
개스오븐레인지	ncn
개스온수기	ncn
개스용량	ncn
개스용품	ncn
개스제품	ncn
개스취사기기	ncn
개스히터	ncn
개시	ncpa
개시시기	ncn
개시연도	ncn
개식	ncpa
개신교	ncn
개신교계	ncn
개신교단체	ncn
개신교도	ncn
개신교신자	ncn
개신교지도자	ncn
개신교파	ncn
개신교회	ncn
개신유학	ncpa
개신유학자	ncn
개심	ncpa
개씹	ii	ncn
개아	ncn
개악	ncpa
개안	ncpa
개안자	ncn
개암	ncn
개암나무	ncn
개암성	nqq
개업	ncpa
개업약사	ncn
개업의	ncn
개업체	ncn
개업체중	ncn
개업파티	ncn
개업희망자	ncn
개에쌔끼	ii
개역	ncpa
개연	ncn
개연성	ncn
개요	ncn
개우개	nqq
개운	ncps
개운사	nqq
개울	ncn
개울가	ncn
개울물	ncn
개원	ncpa
개원가	ncn
개원강행	ncn
개원국회	ncn
개원예정	ncn	ncpa
개원일자	ncn
개원잔치	ncpa
개원정국	ncn
개원협상	ncpa
개월	nbu
개월가량	ncn
개의	ncpa
개이	pvg
개이빨산	nqq
개인	ncn	ncpa
개인간	ncn
개인간병인	ncn
개인경고	ncn	ncpa
개인경기	ncn
개인경연	ncn
개인고객	ncn
개인고용	ncpa
개인관계	ncn
개인관람객	ncn
개인관리능력	ncn
개인교사	ncn
개인교수	ncpa
개인교습	ncpa
개인교통비용	ncn
개인구매자	ncn
개인구원	ncpa
개인근로자	ncn
개인금융	ncn
개인금융자산	ncn
개인금융재산	ncn
개인기	ncn
개인기록	ncn
개인기업	ncn
개인농	ncn
개인능력	ncn
개인단위	ncn
개인대출	ncpa
개인도덕원칙	ncn
개인독재	ncpa
개인돌파	ncpa
개인랭킹	ncn
개인면담	ncpa
개인면담상담	ncpa
개인명의	ncn
개인문제	ncn
개인발명	ncn
개인발명가	ncn
개인번호	ncn
개인별	ncn
개인병원	ncn
개인부문	ncn
개인부정축재	ncpa
개인비리	ncn
개인비리부분	ncn
개인비리수사	ncpa
개인비서	ncn
개인사업	ncn
개인사업자	ncn
개인사업체	ncn
개인사용자	ncn
개인사정	ncn
개인사회	ncn
개인상담	ncpa
개인상점	ncn
개인생활	ncpa
개인생활문제	ncn
개인서류	ncn
개인서비스	ncn
개인서비스업	ncn
개인서비스요금	ncn
개인선전용	ncn
개인성	ncn
개인성적	ncn
개인소득	ncn
개인소득세	ncn
개인소비	ncpa
개인소유	ncpa
개인소장품	ncn
개인숭배	ncpa
개인승인	ncn
개인승인금지	ncpa
개인승인서	ncn
개인시집	ncn
개인시혜	ncpa
개인식별	ncpa
개인신앙	ncn
개인신용	ncn
개인신용대출	ncn
개인신용정보	ncn
개인심리학	ncn
개인아파트	ncn
개인여행자	ncn
개인연금	ncn
개인연금보험	ncn
개인연금신탁	ncn
개인연금저축	ncn
개인연봉	ncn
개인영역	ncpa
개인예금	ncpa
개인완성	ncn
개인용	ncn
개인용도	ncn
개인용무	ncn
개인용컴퓨터	ncn
개인용컴퓨터시장	ncn
개인용팩시밀리	ncn
개인용편입추세	ncn
개인위생	ncn
개인유저	ncn
개인유저층	ncn
개인윤리	ncn
개인의견	ncn
개인의례	ncn
개인의사존중	ncpa
개인의식	ncn
개인의지	ncn
개인의학	ncn
개인이미지표현	ncn
개인이익	ncn
개인자격	ncn
개인자금	ncn
개인자료	ncn
개인자산	ncn
개인자원	ncn
개인작품	ncn
개인재산	ncn
개인재산파악작업	ncpa
개인저축	ncpa
개인전	ncn
개인전시회	ncn
개인전용	ncn
개인전체	ncn
개인정보	ncn
개인정보관리	ncn
개인정보관리프로그램	ncn
개인정보기업	ncpa
개인정보보호	ncpa
개인정보보호문제	ncn
개인정보보호법안	ncn
개인정보보호법제	ncn
개인정보보호제도	ncn
개인종합경기	ncn
개인주의	ncn
개인주의자	ncn
개인주주	ncn
개인주택	ncn
개인지도	ncpa
개인직무기능	ncn
개인차	ncn
개인차원	ncn
개인책임	ncn
개인축재	ncpa
개인치료	ncpa
개인치유	ncpa
개인컴퓨터	ncn
개인타이틀	ncn
개인택시	ncn
개인택시기사	ncn
개인택시운전사	ncn
개인통신세미나	ncn
개인통역	ncpa
개인통화	ncpa
개인투자가	ncn
개인학습	ncpa
개인행위자	ncn
개인화	ncpa
개인활동	ncpa
개인회사	ncn
개인후원회원	ncn
개인휴대	ncn	ncpa
개인휴대성	ncn
개인휴대통신	ncpa
개인휴대통신서비스	ncn
개임부담비율	ncn
개입	ncpa
개입근거	ncpa
개입기회	ncn
개입문제	ncn
개입방식	ncn
개입소문	ncn
개입수단	ncn
개입여부	ncn
개입이전	ncn
개입정도	ncn
개입정책	ncn
개입정책일수록	ncn
개입주의	ncn
개입축소	ncpa
개입형태	ncn
개입흔적	ncn
개자식	ii
개자추	nqpc
개작	ncpa
개작소설	ncn
개작품	ncn
개잡	pvg
개장	ncn	ncpa
개장기념	ncn	ncpa
개장시간	ncn
개장행사	ncpa
개재	ncpa
개재뉴론	ncn
개재료분야	ncn
개전	ncpa
개전일	ncn
개점	ncpa
개점기념	ncpa
개점기념행사	ncpa
개점예정	ncpa
개정	ncpa
개정구빈법	ncn
개정내용	ncn
개정논의	ncpa
개정도	ncn
개정문제	ncn
개정방향	ncn
개정법	ncn
개정법률안	ncn
개정법안	ncn
개정세법	ncn
개정시안	ncn
개정실무소위원회	ncn
개정안	ncn
개정운동	ncpa
개정의견	ncn
개정의사	ncn
개정작업	ncpa
개정투쟁	ncpa
개정판	ncn
개젖통	ncn
개제	ncpa
개조	nbu	ncpa
개조공사	ncn
개조문제	ncn
개조방법	ncn
개조작업	ncpa
개종	ncpa
개주	ncpa
개죽음	ncpa
개중	ncn
개지랄	ncpa
개진	ncpa
개집	ncn
개짖	pvg
개차	ncn
개찬	ncpa
개찰구	ncn
개창	ncpa
개창주	ncn
개척	ncpa
개척고장	ncn
개척단	ncn
개척분야	ncn
개척사업	ncn
개척선교	ncpa
개척시대	ncn
개척자	ncn
개척자중	ncpa
개척정신	ncn
개척토지	ncn
개천	ncn
개천가	ncn
개천용지개	nqpc
개천절	ncn
개체	ncn
개체발생	ncpa
개체성	ncn
개체윤리	ncn
개체주의	ncn
개최	ncpa
개최고수	ncn
개최국	ncn
개최국가	ncn
개최도시	ncn
개최배경	ncn
개최사실	ncn
개최소식	ncn
개최시	ncn
개최시점	ncn
개최연설	ncpa
개최예정	ncpa
개최일자	ncn
개최장소	ncn
개최지	ncn
개최지로	ncn
개최지신청	ncn
개최직전	ncn
개최후보도시	ncn
개축	ncpa
개축공사	ncpa
개축사업	ncn
개축책임	ncn
개칭	ncpa
개칭어	ncn
개코	ncn
개코원숭이	ncn
개탁	ncpa
개탄	ncpa
개탕	ncn
개태사	nqq
개털	ncn
개털모자	ncn
개통	ncpa
개통시기	ncn
개통식	ncn
개통심상학교	ncn
개통업무	ncn
개통예정	ncpa
개통학교	ncn
개통행사	ncpa
개팀	nbu
개판	ncn
개팔자	ncn
개펄	ncn
개편	ncpa
개편과정	ncpa
개편대회	ncn
개편문제	ncn
개편방안	ncn
개편방향	ncn
개편안	ncn
개편작업	ncn	ncpa
개편작업팀	ncn
개편조치	ncpa
개편취지	ncn
개평	ncn	ncpa
개평회	ncn
개폐	ncpa
개폐간	ncn
개폐기	ncn
개폐기시장	ncn
개폐기업체	ncn
개폐기전문생산업체	ncn
개폐문제	ncn
개폐식	ncn
개포	ncn
개포동	nqq
개표	ncpa
개표부정	ncn
개피	nbu	ncn
개학	ncpa
개학날	ncn
개학문화연구회	ncn
개학준비	ncn
개항	ncpa
개항요구	ncpa
개항이후	ncn
개항장	ncn
개항장공사판	ncn
개헌	ncpa
개헌가능성	ncn
개헌논의	ncpa
개헌논쟁	ncpa
개헌문제	ncn
개헌문제제기	ncpa
개헌안	ncn
개헌얘기	ncpa
개헌일정	ncn
개헌정국	ncn
개헌추진	ncpa
개혁	ncpa
개혁가	ncn
개혁개방	ncn
개혁개방정책	ncn
개혁과업	ncn
개혁과정	ncn
개혁기	ncn
개혁기간	ncn
개혁내각	ncn
개혁내용	ncn
개혁노선	ncn
개혁논의	ncpa
개혁단계	ncn
개혁론	ncn
개혁론자	ncn
개혁물결	ncn
개혁바람	ncn
개혁방법	ncn
개혁방안	ncn
개혁방향	ncn
개혁법	ncn
개혁법안	ncn
개혁사상	ncn
개혁사정	ncn
개혁사조	ncn
개혁성공	ncpa
개혁성향	ncn
개혁세력	ncn
개혁세력간	ncn
개혁시대	ncn
개혁시책	ncn
개혁신당	ncn
개혁실패	ncpa
개혁실현	ncpa
개혁안	ncn
개혁열병	ncn
개혁요구	ncpa
개혁운동	ncpa
개혁원리	ncn
개혁위원회	ncn
개혁의지	ncn
개혁의회	ncn
개혁입법	ncpa
개혁자	ncn
개혁작업	ncpa
개혁전담특별조직	ncpa
개혁전면	ncn
개혁정국	ncn
개혁정당	ncn
개혁정신	ncn
개혁정책	ncn
개혁정치	ncn
개혁조치	ncpa
개혁주의	ncn
개혁주의자	ncn
개혁지향	ncpa
개혁진영	ncn
개혁청사진	ncn
개혁추진자	ncn
개혁투사	ncn
개혁투쟁	ncpa
개혁파	ncn
개혁프로그램	ncn
개혁회의	ncpa
개형	ncpa
개호	ncn
개호지	ncn
개화	ncpa
개화기	ncn
개화기연구	ncn
개화당	nqq
개화당정권	ncn
개화당파	ncn
개화문명	ncn
개화사상	ncn
개화사상가	ncn
개화시대	ncn
개화운동	ncpa
개화의지	ncn
개화인사	ncpa
개화자강계열	ncn
개화정책	ncn
개화지식층	ncn
개화파	ncn
개화파정권	ncn
개회	ncpa
개회기도	ncn
개회벽두	ncn
개회사	ncn
개회선언	ncn	ncpa
개회식	ncn
개획	ncpa
개흉	ncpa
객	ncn
객관	ncn
객관가	ncn
객관방법	ncn
객관사물	ncn
객관성	ncn
객관세계	ncn
객관유심론	ncn
객관유심주의	ncn
객관유심주의론자	ncn
객관유심주의자	ncn
객관인식	ncpa
객관정세	ncn
객관정신	ncn
객관주의	ncn
객관현실	ncn
객관화	ncpa
객관화과정	ncn
객관화해	ncpa
객기	ncn
객담	ncpa
객방	ncn
객사	ncn	ncpa
객석	ncn
객선	ncn
객수	ncn
객실	ncn
객실온도	ncn
객실요금	ncn
객실전용건물	ncn
객원	ncn
객원교수	ncn
객장	ncn
객점	ncn
객주점	ncn
객주집	ncn
객지	ncn
객쩍	paa
객차	ncn
객창	ncn
객체	ncn
객체지향	ncn
객토	ncpa
객토작업	ncpa
객화차대	ncn
갠즈	nqq
갠지스	nqq
갠지스강	nqq
갠지스유역	ncn
갠지즈	nqq
갤러리	ncn
갤러리시우터	ncn
갤러리아	ncn
갤러리아백화점	ncn
갤러리현대	ncn
갤러리홀	ncn
갤럭시	ncn
갤럽	ncn
갤럽조사	ncn
갤럽조사연구소	ncn	nqq
갤로퍼	nqq
갤로퍼승용차	nqq
갤로퍼자동차	nqq
갤로퍼지프	nqq
갤륨	ncn
갤륨비소	ncn
갤륨비소반도체	ncn
갤륨비소반도체산업	ncn
갤륨비소반도체소자	ncn
갤륨비소반도체시장	ncn
갤륨비소소자	ncn
갤륨비소에피층	ncn
갤륨비소응용제품	ncn
갤륨안치몬반도체	ncn
갤브레이드	nqpc
갤브레이스	nqpc
갤빈	nqpc
갬사쿠르디야	nqpc
갭	ncn
갭리스피뢰기	ncn
갭리스형	ncn
갭형피뢰기	ncn
갯가	ncn
갯마을	ncn
갯바닥	ncn
갯바위	ncn
갯버들	ncn
갯벌	ncn
갯벌청소	ncpa
갯수	ncn
갱	ncn
갱구	ncn
갱내폭발	ncn
갱년기	ncn
갱단	ncn
갱목	ncn
갱생	ncn
갱생가능성	ncn
갱생보호	ncn
갱생원	ncn
갱신	ncpa
갱신기	ncn
갱신등록	ncpa
갱조직	ncn
갱지	ncn
갸륵	ncps
갸름	ncps
갸우뚱	ncpa
갸우뚱거리	pvg
갸웃거리	pvg
갸웃하	paa	pvg
갹출	ncpa
걔	npp
걜륨비소	ncn
거	ii
거간꾼놈	ncn
거개	ncn
거골	ncn
거골사이	ncn
거구	ncn
거국	ncn
거국내각	ncn
거국연정	ncn
거근	ncn
거금	mag	ncn
거기	mad	npd
거꾸로	mag
거꾸로서	pvg
거꾸로오르	pvg.irrlu
거나	ecc	ecs	ncps
거년	ncn
거느리	pvg
거늘	ecs
거니	ecc	ecs
거니와	ecs
거닐	pvg
거당	ncn
거대	ncps
거대과학	ncn
거대국가	ncn
거대군부	ncn
거대규모	ncn
거대기업	ncpa
거대단체	ncn
거대도시	ncn
거대부서	ncn
거대분자	ncn
거대성	ncn
거대세력	ncn
거대시장	ncn
거대업체	ncn
거대여당	ncn
거대이론	ncn
거대재벌중심	ncn
거대정당	ncn
거대정보처리전문업체	ncn
거대파벌	ncn
거대화	ncpa
거대회사	ncn
거덜	ncn
거덜거리	ncn
거동	ncpa
거두	ncn	pvg
거두절미	ncpa
거드름	ncn
거든	ecs	ef
거든요	ecs	ef
거들	ncn	pvg
거들떠보	pvg
거들뜨	pvg
거들먹거리	pvg
거듭	mag	ncpa
거듭거듭	mag
거듭나	pvg
거뜬히	mag
거라	ef
거란	nqq
거란군	nqq
거란족	nqq
거란판	ncn
거랑	ncn	ncpa
거래	ncpa
거래가격	ncn
거래감소	ncpa
거래계약	ncpa
거래계약서상	ncn
거래계좌	ncn
거래고객	ncn
거래관계	ncpa
거래관습	ncn
거래관행	ncn
거래교섭	ncpa
거래금액	ncn
거래기간	ncn
거래내역	ncn
거래내용	ncn
거래단위	ncn
거래당사자	ncn
거래대금	ncn
거래대상	ncn
거래량	ncn
거래문서	ncn
거래문제	ncn
거래방식	ncn
거래법	ncn
거래부문	ncn
거래분석	ncpa
거래비용	ncn
거래비용감소	ncpa
거래사상	ncn
거래상대	ncpa
거래상대방	ncn
거래상황	ncn
거래선	ncn
거래소	ncn
거래수단	ncn
거래수량설	ncn
거래수수료	ncn
거래수준	ncn
거래수행	ncpa
거래승인	ncpa
거래시장	ncn
거래신고	ncpa
거래실적	ncn
거래실제가격	ncn
거래실태	ncn
거래알선	ncpa
거래압력	ncn
거래업무	ncn
거래요구	ncpa
거래은행	ncn
거래일자	ncn
거래자	ncn
거래자금	ncn
거래정보	ncn
거래정지처분	ncn
거래제도	ncn
거래조건	ncn
거래종목	ncn
거래중재	ncpa
거래중지	ncpa
거래지원	ncpa
거래진상	ncpa
거래질서	ncn
거래처	ncn
거래처리방법	ncn
거래처별	ncn
거래허가	ncn
거래현황	ncn
거래환율	ncn
거래회사	ncn
거렁벵이	ncn
거론	ncpa
거룩	ncn	ncps
거룻배	ncn
거류민	ncn
거류민단	ncn
거류외인	ncn
거르	pvg.irrlu
거름	ncn
거름종이	ncn
거름주기	ncn
거름지게	ncn
거리	nbn	nbu	ncn
거리감	ncn
거리끼	pvg
거리낌	ncn
거리낌없	paa
거리낌없이	mag
거리노선	ncn
거리상	ncn
거리일대	ncn
거리투쟁	ncpa
거리행렬굿	ncn
거리행진	ncpa
거마비	ncn
거만	ncn	ncps
거만떨	pvg
거머리	ncn
거머잡	pvg
거머쥐	pvg
거멓	paa.irrh
거명	ncpa
거목	ncn
거무스름하	paa
거무튀튀하	paa
거무티티하	paa
거무틱틱하	paa
거문고	ncn
거문고곡	ncn
거문고소리	ncn
거문고솜씨	ncn
거문고자리	ncn
거문고줄	ncn
거문도	nqq
거문도사건	ncn
거물	ncn
거물감독	ncpa
거물급	ncn
거물인사	ncn
거물정치인	ncn
거뭇거뭇	mag
거뭇하	paa
거미	ncn
거미인간	ncn
거미줄	ncn
거미집	ncn
거민	ncn
거밋거밋하	paa
거버	nqq
거버너모터	nqq
거버넌스	ncn
거병	ncpa
거보	ncn
거부	ncn	ncpa
거부감	ncn
거부권	ncn
거부논리	ncn
거부반응	ncn	ncpa
거부방침	ncn
거부사건	ncn
거부선언	ncpa
거부운동	ncpa
거부의사	ncn
거부이유	ncn
거부입장	ncn
거북	ncn	ncps
거북놀이	ncpa
거북님	ncn
거북등	ncn
거북무늬	ncn
거북바위	ncn
거북상	ncn
거북선	nqq
거북이	ncn
거북이봉	nqq
거북이일지	ncn
거북이투사	nqq
거붕	ncn
거사	ncn
거상	ncn	ncpa
거상근	ncn
거성	ncn
거세	ncn	ncpa	paa
거세자	ncn
거센소리	ncn
거손	nqpc
거수	ncpa
거수경레	ncpa
거수경례	ncpa
거수기	ncn
거스르	pvg.irrlu
거스름	ncn
거스름돈	ncn
거슬리	pvg
거슴츠레	mag
거슴츠레하	paa
거시	ncn
거시경제	ncn
거시경제모형	ncn
거시경제예측모형시안	ncn
거시경제정책	ncn
거시기	ii	npd
거시모형개발	ncpa
거시영역	ncpa
거시이론	ncn
거시정치학	ncn
거시지표	ncn
거식처	ncn
거실	ncn
거실가구	ncn
거실문	ncn
거실바닥	ncn
거액	ncn
거액부채때문	ncn
거액예금	ncn	ncpa
거액자금	ncn
거액자산가	ncn
거액전주	ncn
거액탈세	ncn
거액투자가	ncn
거액환매채	ncn
거야	ncn
거양실업	nqq
거역	ncpa
거역성	ncn
거연히	mag
거울	ncn
거울개발	ncn
거울놀이	ncn
거울삼	pvg
거위	ncn
거위새끼	ncn
거위알	ncn
거위튀김	ncn
거유	ncn	ncpa
거의	mag	ncpa
거인	ncn
거작	ncn
거장	ncn
거재	ncpa
거저	mag
거적	ncn
거절	ncpa
거절률	ncn
거절사건	ncn
거절증	ncn
거점	ncn
거점국가	ncn
거점지역	ncn
거제	nqq
거제군	ncn
거제도	nqq
거제도포로수용소	ncn
거제시	ncn
거제항	ncn
거족	ncn
거족적	ncn
거종	ncn
거주	ncpa
거주공간	ncn
거주기지	ncn
거주단위아파트	ncn
거주민	ncn
거주서비스	ncpa
거주설비	ncn
거주유형	ncn
거주이전	ncpa
거주자	ncn
거주지	ncn
거주지구	ncn
거주지역	ncn
거주패턴	ncn
거주형식	ncn
거주환경	ncn
거죽	ncn
거중기	ncn
거중조정	ncpa
거즈	ncn
거지	ncn
거지꼴	ncn
거진	mag
거짓	ncn	ncpa	ncps
거짓감정	ncpa
거짓말	ncpa
거짓말쟁이	ncn
거짓말쟁이라고	ncn
거짓말탐지기	ncn
거짓범죄	ncpa
거짓사랑	ncn
거짓싸움솜씨	ncn
거짓정보	ncn
거짓종교	ncn
거찰	ncn
거참	ii
거창	ncps	nqq
거창군	nqq
거창군당	ncn
거창농업학교	ncn
거창지역	ncn
거창합천	ncn
거채	ncn
거처	ncn	ncpa
거추	ncn
거추장	ncps
거취	ncn
거취문제	ncn
거치	ncpa	pvg
거치장	ncps
거치적거리	pvg
거치형	ncn
거칠	paa
거칠부	nqpc
거침	ncn
거침없이	mag
거칫	ncps
거쿨지	paa
거택보호대상자	ncn
거튼	nqpc
거평그룹	ncn
거포	ncn
거푸	mag
거푸집	ncn
거품	ncn
거품경제	ncn
거품경제시대	ncn
거품사람	ncn
거품상자	ncn
거품시대	ncn
거품이	pvg
거품인기	ncn
거품일	pvg
거품제거	ncpa
거품현상	ncn
거풍	ncpa
거하	paa	pvg
거한	ncn
거함	ncn
거행	ncpa
걱정	ncpa
걱정거리	ncn
걱정마	pvg
걱정말	pvg
걱정스레	mag
건	ecc	ecs	nbu	ncn	xsnx
건가	ncn
건강	ncps
건강가습	ncn
건강강연회	ncn
건강과학센터	ncn
건강관리	ncpa
건강관리시스팀	ncn
건강권확보	ncpa
건강기구	ncn
건강난방	ncn
건강난방기능	ncn
건강단련	ncn
건강달리기	ncn
건강때문	ncn
건강문제	ncn
건강미	ncn
건강보장	ncn	ncpa
건강보조식품	ncn
건강보존	ncpa
건강보험	ncn
건강보험료	ncn
건강복지	ncn
건강분야	ncn
건강비결	ncn
건강사회	ncn
건강산업	ncn
건강상식	ncn
건강상태	ncn
건강상태진단	ncn
건강성	ncn
건강세포	ncn
건강센터	ncn
건강소식	ncn
건강수준	ncn
건강식	ncn
건강식품	ncn
건강악화	ncpa
건강약재	ncn
건강요법	ncn
건강운동	ncpa
건강유지	ncpa
건강음료	ncn
건강인	ncn
건강일색	ncn
건강작전	ncn
건강장수	ncn
건강점검	ncpa
건강정보	ncn
건강증진	ncpa
건강지식	ncn
건강진단	ncpa
건강진단센터	ncn
건강진단수첩	ncn
건강질병기록	ncpa
건강체	ncn
건강체조	ncn
건강체질	ncn
건강학	ncn
건강해지	pvg
건강효과	ncn
건강히	mag
건건찝질하	paa
건곤	ncn
건과	ncn
건교부	ncn
건교부안	ncn
건교부차관	ncn
건교위	ncn
건구	nqpb
건국	ncpa
건국공로훈장	ncn
건국년	ncn
건국당시	ncn
건국대	nqq
건국대총장	ncn
건국대학	nqq
건국대학교	nqq
건국세력	ncn
건국신화	ncn
건국운동	ncpa
건국이후	ncn
건국준비위	ncn
건국준비위원회	ncn
건국차원	ncn
건국초기	ncn
건국포장	ncn
건국훈장	ncn
건군	ncpa
건규	nqpb
건기	ncn
건너	pvg	xp
건너가	pvg
건너다보	pvg
건너다보이	pvg
건너뛰	pvg
건너지르	pvg.irrlu
건너쪽	ncn
건너편	ncn
건넌방	ncn
건널목	ncn
건널목사고	ncn
건넛마을	ncn
건넛방	ncn
건넛집	ncn
건네	pvg
건네받	pvg
건네주	pvg
건달	ncn
건달바	ncn
건달청년	ncn
건달패	ncn
건대	nqq
건더기	ncn
건데	ecs
건데기	ncn
건도	ncpa
건동	nqpb
건드리	pvg
건들거리	pvg
건등	ncn
건뜻	mag
건륭	ncn
건륭문화	ncn
건륭황제	ncn
건립	ncpa
건립계획	ncpa
건립공사	ncpa
건립비용	ncn
건립사업	ncn
건립주체	ncn
건립준공식	ncn
건립추진위원회	ncn
건마는	ecs
건망증	ncn
건면	ncn
건모	nqpb
건무	nqq
건무제	nqq
건물	ncn
건물공사	ncpa
건물관리	ncn
건물관리이사회	ncn
건물관리인	ncn
건물내부	ncn
건물매각자금	ncn
건물보수작업	ncpa
건물붕괴	ncpa
건물붕괴위험	ncpa
건물설계	ncpa
건물설비공사	ncn
건물신축	ncpa
건물안	ncn
건물안전관리실태	ncn
건물옥상	ncn
건물외관	ncn
건물외벽	ncn
건물외장	ncn
건물이름	ncn
건물임대료	ncn
건물저층부	ncn
건물전체	ncn
건물정치범	ncn
건물주	ncn
건물증축	ncpa
건물철거	ncn
건물축조공사	ncn
건물해체	ncn
건물해체공사	ncn
건반	ncn
건반악기	ncn
건방지	paa
건배	nqpb
건복	nqpb
건비연	nqq
건상	nqpb
건서	nqpb
건석	nqpb
건선	nqpb
건설	ncpa
건설감림	ncn
건설경기	ncn
건설경기전망	ncn
건설경비	ncpa
건설계획	ncpa
건설공사	ncpa
건설공사장	ncn
건설공해	ncn
건설과정	ncn
건설관계법	ncn
건설관련	ncn
건설관리	ncn
건설교통부	ncn
건설교통부장관	ncn
건설교통위원회	ncn
건설규제	ncn
건설기	ncn
건설기간	ncn
건설기계	ncn
건설기공식	ncn
건설기술	ncn
건설기술연구원	nqq
건설기술자	ncn
건설노동자	ncn
건설노선	ncn
건설노임	ncn
건설단	ncn
건설면허	ncn
건설문제	ncn
건설물	ncn
건설방식	ncn
건설방안	ncn
건설본부	ncn
건설부	nqq
건설부문	ncn
건설부장관	ncn
건설부재	ncpa
건설부지	ncn
건설분야	ncn
건설붐	ncn
건설비	ncn
건설비부담	ncpa
건설비용	ncn
건설비중	ncn
건설사고	ncn
건설사례비	ncn
건설사무소	ncn
건설사업	ncpa
건설사업계획	ncpa
건설산업	ncn
건설설계	ncn
건설수요	ncn
건설수주	ncpa
건설수주계약	ncpa
건설수주전	ncn
건설수주전선	ncn
건설시기	ncn
건설시장	ncn
건설안	ncn
건설업	ncn
건설업계	ncn
건설업계관행	ncn
건설업무	ncn
건설업법	ncn
건설업자	ncn
건설업체	ncn
건설예정지	ncn
건설용어	ncn
건설인력	ncn
건설임무	ncn
건설자	ncn
건설자금	ncn
건설자재	ncpa
건설자절	ncn
건설작업	ncpa
건설장	ncn
건설장관	ncn
건설장비	ncn
건설장소	ncn
건설재원	ncn
건설재해	ncn
건설정책	ncn
건설주	ncn
건설주가	ncn
건설주제	ncn
건설중장비	ncn
건설중장비메이커	ncn
건설중장비산업	ncn
건설중장비업계	ncn
건설중장비업체	ncn
건설지원	ncpa
건설초기	ncn
건설투자	ncpa
건설행정	ncn
건설허가	ncpa
건설현장	ncn
건설협력	ncn
건설활동	ncpa
건설회관	ncn
건설회사	ncn
건섭	nqpb
건성	ncn
건송리	ncn
건수	ncn
건숙	nqpb
건순	nqpb
건스모크	nqq
건습구	ncn
건승	ncpa
건식	ncn
건식도금	ncpa
건식전지	ncn
건실	ncps
건실성	ncn
건아	ncn
건안하	paa
건양	nqpb
건양다경	ncn
건양대학교	nqq
건양원년	ncn
건어물	ncn
건어물전	ncn
건업	ncn
건영	ncn
건오	nqpb
건옥	nqpb
건용	nqpb
건우	nqpb
건욱	nqpb
건웅	nqpb
건위작용	ncpa
건의	ncpa
건의권	ncn
건의내용	ncn
건의문	ncn
건의서	ncn
건의안	ncn
건의함	ncn
건인시스템	nqq
건일	nqpb
건자	nqpb
건자재	ncn
건잠머리	ncn
건장	ncps
건재	ncn	ncps
건전	ncn	ncps
건전가요	ncn
건전경쟁	ncn
건전비디오문화	ncn
건전비디오문화조기정착운동	ncn
건전성	ncn
건전성규제	ncpa
건전음반	ncn
건전지	ncn
건전화	ncn
건제	nqpb
건조	ncpa
건조기	ncn
건조기술	ncn
건조단열선	ncn
건조대	ncn
건조로	ncn
건조물	ncn
건조식	ncn
건조식품	ncn
건조실	ncn
건조업체	ncn
건조지대	ncn
건조지역	ncn
건조참여	ncn
건조현장	ncn
건조환경	ncn
건종	nqpb
건주	nqpb
건준	ncn
건중	nqpb
건지	ncn	pvg
건진	nqpb
건창	nqpb
건책	ncpa
건천	ncn
건천읍	ncn
건천지역	ncn
건천화	ncn
건천화현상	ncn
건철	nqpb
건청궁	nqq
건축	ncpa
건축가	ncr
건축가그룹	ncn
건축가철	ncn
건축감독	ncn
건축감리	ncn
건축감상	ncpa
건축건설사업	ncn
건축경기	ncn
건축계	ncn
건축계획	ncpa
건축고도제한	ncn
건축공간	ncn
건축공사	ncpa
건축공사비	ncn
건축공학	ncn
건축공학과	ncn
건축공학박사학위	ncn
건축과	ncn
건축과정	ncn
건축관	ncn
건축구조물	ncn
건축규제	ncpa
건축기계	ncn
건축기념물	ncn
건축기법	ncn
건축기술	ncn
건축기술자	ncn
건축기술학과	ncn
건축기준	ncn
건축기타	ncn
건축기획관	ncn
건축노동자	ncn
건축대상	ncn
건축대학원	ncn
건축도구	ncn
건축디자인박물관	ncn
건축론	ncn
건축론비판	ncpa
건축마무리공사	ncn
건축문	ncn
건축문화	ncn
건축물	ncn
건축물관리	ncn
건축물장식	ncpa
건축물장식수법	ncn
건축물해체	ncn
건축미	ncn
건축미술	ncn
건축미술과	ncn
건축발달	ncpa
건축발전	ncpa
건축방식	ncn
건축법	ncn
건축법규	ncn
건축법위반	ncn
건축법위반사범	ncn
건축부문	ncn
건축부장	ncn
건축부재	ncn
건축부지	ncn
건축분야	ncn
건축붐	ncn
건축비	ncn
건축비평가	ncpa
건축사	ncr
건축사무소장	ncn
건축사사무소	ncn
건축사상	ncn
건축사업	ncn
건축사학자	ncn
건축상	ncn
건축설계	ncn
건축설계사	ncn
건축설계사무소	ncn
건축설계사무실	ncn
건축설계학	ncn
건축술	ncn
건축양식	ncn
건축언어	ncn
건축업	ncn
건축업계	ncn
건축업자	ncn
건축에니메이션	ncn
건축예술	ncn
건축용지	ncn
건축용합판	ncn
건축운동	ncpa
건축원리	ncn
건축위반	ncn
건축유형	ncn
건축이론	ncn
건축자	ncn
건축자재	ncn
건축작품	ncn
건축장면	ncn
건축장식	ncpa
건축장식기술	ncn
건축재	ncn
건축재료	ncn
건축전문대학원	ncn
건축제한	ncpa
건축주	ncn
건축평면	ncn
건축폐기물	ncn
건축학	ncn
건축학과	ncn
건축학교	ncn
건축학도	ncn
건축학자	ncn
건축학회	ncn
건축행위	ncpa
건축행정	ncn
건축허가	ncpa
건축허가면적	ncn
건축허가부서	ncn
건축형태	ncn
건축환경	ncn
건축활동	ncpa
건축회사	ncn
건태	nqpb
건택	nqpb
건평	ncn
건폐율	ncn
건포	ncn
건포도	ncn
건표	nqpb
건하	nqpb
건혁	nqpb
건형	nqpb
건호	nqpb
건화	nqpb
건화전기	nqq
건환	nqpb
건훈	nqpb
건희	nqpb
걷	pvg	pvg.irrd
걷기	ncn
걷기운동	ncn
걷어차	pvg
걷잡	pvg
걷히	pvg
걸	ncn	pvg
걸개그림	ncn
걸걸	mag
걸걸중상	nqq
걸고우	nqpc
걸귀들리	pvg
걸기	ncn
걸기대	ncn
걸래	ncn
걸러지	pvg
걸레	ncn
걸레장사	ncn
걸레질	ncpa
걸레쪽	ncn
걸리	pvg
걸리버	nqq
걸림돌	ncn
걸림없	paa
걸림현상	ncn
걸립패	ncn
걸맞	paa
걸머지	pvg
걸메	pvg
걸바	ncn
걸사	ncn
걸사용장	ncn
걸상	ncn
걸스카우트	ncn
걸식	ncpa
걸신	ncn
걸어가	pvg
걸어놓	pvg
걸어다니	pvg
걸어오	pvg
걸음	nbu	ncn
걸음걸음	ncn
걸음걸이	ncn
걸음마	ii	ncn
걸음마단계	ncn
걸음새	ncn
걸이	ncn
걸인	ncn
걸임금	nqq
걸작	ncn
걸작품	ncn
걸죽	ncps
걸출	ncps
걸치	pvg
걸터앉	pvg
걸프	ncn
걸프국가	ncn
걸프만	nqq
걸프만사태	nqq
걸프사태	nqq
걸프전	nqq
걸프전위기	ncn
걸프전쟁	nqq
걸프지역	ncn
걸프해	nqq
걸프해역	ncn
걸핏	ncpa
걸핏하면	mag
검	ncn	paa
검객	ncn
검거	ncpa
검거사건	ncn
검거선풍	ncn
검거시	ncn
검거율	ncn
검거전담반	ncn
검결	ncn
검도	ncn
검둥	ncn
검둥개	ncn
검둥이	ncn
검무	ncn
검문	ncpa
검문검색	ncpa
검문소	ncn
검문장소	ncn
검버섯	ncn
검법	ncn
검불	ncn
검붉	paa
검사	ncpa	ncr
검사결과	ncn
검사계획	ncpa
검사공정	ncn
검사과정	ncn
검사관	ncr
검사규격	ncn
검사기	ncn
검사기관	ncn
검사기기	ncn
검사기능	ncn
검사놈	ncn
검사대	ncn
검사대상	ncn
검사도구	ncn
검사발령	ncpa
검사비	ncn
검사비리	ncn
검사생활	ncpa
검사수수료	ncn
검사수수료율	ncn
검사식	ncn
검사실시자격	ncn
검사실적	ncn
검사업무	ncn
검사역	ncn
검사요금	ncn
검사원	ncr
검사작성	ncpa
검사장	ncr
검사장방	ncn
검사장비	ncn
검사장비업체	ncn
검사장치	ncn
검사제6국	ncn
검사제도	ncn
검사조사	ncn
검사종목	ncn
검사지상주의	ncn
검사직	ncn
검사총장	ncn
검사출신	ncn
검사형	ncn
검산	ncpa
검산법	ncn
검색	ncpa
검색가능	ncps
검색기	ncn
검색기능	ncn
검색대	ncn
검색도구	ncn
검색방법	ncn
검색시스템	ncn
검색요원	ncn
검색율	ncn
검색작업	ncpa
검색프로그램	ncn
검소	ncn	ncps
검수료	ncn
검수요금	ncn
검시	ncpa
검시결과	ncn
검시관	ncr
검시자	ncn
검안	ncn
검안사	ncn
검여	nqq
검역	ncn
검역관	ncr
검역원	ncr
검역제도	ncn
검열	ncpa
검열관	ncn
검열국	ncn
검열기구	ncn
검열기준	ncn
검열방법	ncn
검열제도	ncn
검은돌	ncn
검은상자	ncn
검은색	ncn
검은용	ncn
검인	ncpa
검인정	ncpa
검인정교과서	ncn
검정	ncn	ncpa
검정고무신	ncn
검정고시	ncn
검정교과서	ncn
검정대상기기	ncn
검정말	ncn
검정바지	ncn
검정빛	ncn
검정색	ncn
검정수수료	ncn
검정시험	ncpa
검정심의회의	ncpa
검정황소	ncn
검정회사	ncn
검중과정	ncn
검증	ncpa
검증과정	ncn
검증기관	ncn
검증기능	ncn
검증기준	ncn
검증방법	ncn
검증시간	ncn
검증의무화규정	ncn
검증작업	ncn
검지	ncn
검진	ncpa
검질기	pvg
검찰	ncn
검찰결정	ncn
검찰계장	ncpa
검찰고발	ncpa
검찰고위간부	ncn
검찰고위관계자	ncn
검찰고위직	ncn
검찰관	ncr
검찰관계자	ncn
검찰권	ncn
검찰권행사	ncpa
검찰기소	ncpa
검찰기소과정	ncn
검찰내부	ncn
검찰내사	ncn
검찰논리	ncn
검찰눈치	ncn
검찰답변	ncpa
검찰발표	ncpa
검찰방문조사	ncn
검찰방침	ncn
검찰보고	ncn
검찰분석자료	ncn
검찰분위기	ncn
검찰소식통	ncn
검찰소환	ncpa
검찰소환소식	ncn
검찰수뇌부	ncn
검찰수배	ncpa
검찰수사	ncpa
검찰수사결과	ncn
검찰수사결과발표	ncpa
검찰수사과정	ncpa
검찰수사관	ncn
검찰승용차	ncn
검찰안팎	ncn
검찰영장	ncn
검찰인력	ncn
검찰인사	ncn
검찰입장	ncn
검찰조사	ncn
검찰조사과정	ncn
검찰조직	ncpa
검찰주변	ncn
검찰주사	ncn
검찰주장	ncpa
검찰직원	ncn
검찰진술	ncn	ncpa
검찰쪽	ncn
검찰처분	ncpa
검찰청	ncn	nqq
검찰청사	ncn
검찰청사소환	ncpa
검찰총장	ncr
검찰출두	ncpa
검찰표정	ncn
검출	ncpa
검출거리	ncn
검출관	ncn
검출기	ncn
검출기준치	ncn
검출작업	ncpa
검출장치	ncn
검충충하	paa
검침관리자동화	ncn
검토	ncpa
검토과정	ncn
검토대상	ncn
검토방향	ncn
검토사항	ncn
검토실	ncn
검토의견	ncn
검토작업	ncpa
검토항목	ncn
검파방식	ncn
검표	ncpa
검표원	ncn
검푸르	paa.irrle
겁	ncn
겁나	pvg
겁내	pvg
겁먹	pvg
겁보	ncn
겁없	paa
겁쟁이	ncn
겁주	pvg
겁탈	ncpa
것	nbn
겅뱌오	nqpc
겉	ncn
겉멋	ncn
겉모습	ncn
겉모양	ncn
겉문	ncn
겉보기	ncn
겉보리	ncn
겉봉	ncn
겉봉투	ncn
겉옷	ncn
겉장	ncn
겉장사	ncn
겉쪽	ncn
겉치레	ncpa
겉치마	ncn
겉표지	ncn
겉핥기	ncn
겉핥기식	ncn
겉흙	ncn
게	ecc	ecs	ecx	ef	jca	npp
게거품	ncn
게걸음	ncpa
게급분열	ncpa
게끔	ecx
게나	ef
게나마	ecs	jca
게네	npp
게놈	ncn
게다	ncn
게다가	maj
게도	jca
게딱지	ncn
게라쉬첸코	nqpc
게라슈첸코	nqpc
게라시모프	nqq
게라시센코	nqpc
게라시첸코	nqpc
게라심	nqq
게레	nqq
게르마니스텐	nqq
게르만	nqq
게르만민족	ncn
게르만법	ncn
게르만어	ncn
게르만인	ncn
게르첸	nqq
게르츠	nqq
게르하르트	nqq
게르하르트슈톨덴베르크	nqpc
게르하르트슈톨텐베르그	nqpc
게르하르트슈톨텐베르크	nqpc
게리	nqq
게릴라	ncn
게릴라공격	ncpa
게릴라부대	ncn
게릴라세력	ncn
게릴라식	ncn
게릴라운동	ncpa
게릴라작전	ncpa
게릴라전	ncn
게릴라전법	ncn
게릴라전투	ncn	ncpa
게릴라투쟁	ncpa
게만	jca
게목	ncn
게바라	nqq
게사니	ncn
게새우	ncn
게송	ncn
게슈탈트	ncn
게슈탈트주의	ncn
게슈탈트주의자	ncn
게스	ncn
게스청바지	nqq
게스트	ncn
게슴츠레	mag
게슴츠레이	mag
게시	ncpa
게시내용	ncn
게시문	ncn
게시판	ncn
게시판서비스	ncn
게약체결	ncpa
게양	ncn
게양대	ncn
게오르게	nqq
게오르게바실리오	nqpc
게오르게바실리오우	nqpc
게오르게바실리우	nqpc
게오르규	nqpc
게오르규쿠나제	nqpc
게오르그	nqq
게오르그메르데스	nqpc
게오르그솔티	nqpc
게오르그쿠나제	nqpc
게오르기	nqpc
게오르기라주모프스키	nqpc
게오르기라즈모프스키	nqpc
게으르	paa.irrlu
게으름	ncn
게으름뱅이	ncn
게을리	mag
게을리하	pvg
게이	ncn
게이고	nqpc
게이다르	nqpc
게이다르알리에프	nqpc
게이다르알리예프	nqpc
게이단렌	ncn
게이바	ncn
게이보오단	nqq
게이스케	nqpc
게이오대	ncn
게이와	nqpc
게이조	nqpc
게이지	nqq
게이지로	nqpc
게이토스	ncn
게이트	ncn
게이트류	ncn
게이트볼	ncn
게이트어레이	ncn
게인	ncn
게인즈버러	nqq
게일	nqpc
게임	ncn	ncpa
게임경진	ncpa
게임규칙	ncn
게임기	ncn
게임기계	ncn
게임기공급업체	ncn
게임기구입자	ncn
게임기기	ncn
게임기사업	ncpa
게임기소프트웨어	ncn
게임기시장	ncn
게임기업업체	ncn
게임기업체	ncn
게임기종	ncn
게임기판매	ncpa
게임기회사	ncn
게임리더	ncn
게임리드	ncn
게임리듬	ncn
게임마스터선발대회	nqq
게임보이	nqq
게임산업	ncn
게임소프트웨어	ncn
게임소프트웨어분야	ncn
게임시장	ncn
게임왕	ncn
게임왕국	ncn
게임용소프트웨어전문업체	ncn
게임용퍼스컴	ncn
게임운영	ncn	ncpa
게임이론	ncn
게임차	ncn
게임참가자	ncn
게임형식	ncn
게장	ncn
게재	ncpa
게재기사	ncn
게침	ncn
게토	nqq
게토레이	nqq
게하르트	ncn
게헨나	ncn
게획경제	ncn
게힌놈	ncn
겐고	nqpc
겐나디	ncn
겐나디니콜라예비치	nqpc
겐나디로주데스트벤스키	nqpc
겐나디로지데스트벤스키	nqpc
겐나디브르불리스	nqpc
겐나디브르브리스	nqpc
겐나디야나에프	nqpc
겐나디야나예프	nqpc
겐이치	nqpc
겐이치로	nqpc
겐조	nqpc
겐지	nqpc
겐지로	nqpc
겐타로	nqpc
겐틸	nqq
겔국	mag	ncn
겔로퍼	nqq
겔프당	nqq
겜보이	nqq
겜스타	nqq
겜스타사	nqq
겟세마네	nqq
겟팅	ncn
겠	ep
겨	ncn
겨냥	ncpa
겨누	pvg
겨드랑	ncn
겨드랑이	ncn
겨드랑이털	ncn
겨레	ncn
겨루	pvg
겨루기	ncn
겨를	ncn
겨릅	ncn
겨우	mag
겨우겨우	mag
겨우내	mag
겨우살이	ncn
겨울	ncn
겨울기간	ncn
겨울기상조건	ncn
겨울기온	ncn
겨울나	pvg
겨울나그네	nqq
겨울나라	ncn
겨울난방용품	ncn
겨울난방용품시장	ncn
겨울날	ncn
겨울날씨	ncn
겨울대여시장	ncn
겨울들머리	ncn
겨울문턱	ncn
겨울바람	ncn
겨울밤	ncn
겨울방학	ncn
겨울방학기간	ncn
겨울방학생활	ncpa
겨울방학특수	ncn
겨울보리	ncn
겨울비	ncn
겨울산	ncn
겨울상품	ncn
겨울상품가	ncn
겨울상품특별기획행사	ncn
겨울상황	ncn
겨울새	ncn
겨울성수기	ncn
겨울스포츠	ncn
겨울시장	ncn
겨울시즌	ncn
겨울양복	ncn
겨울여정	ncn
겨울옷	ncn
겨울외출	ncpa
겨울용품	ncn
겨울용품시장	ncn
겨울의류대목	ncn
겨울인기상품	ncn
겨울잠	ncn
겨울잡화	ncn
겨울증시	ncn
겨울철	ncn
겨울철로	ncn
겨울철설경	ncn
겨울추위	ncn
겨울코트	ncn
겨울콘서트	ncn
겨울패션	ncn
겨울피부	ncn
겨울학기말	ncn
겨울호	ncn
겨울휴가	ncn
겨자	ncn
겨자먹	pvg
겨자먹기	ncn
겨자씨	ncn
격	nbn	ncn
격감	ncpa
격감율	ncn
격감추세	ncn
격검	ncpa
격관계	ncn
격구	ncn
격납고	ncn
격납용기	ncn
격년	ncn
격년제	ncn
격노	ncpa
격노감정	ncpa
격돌	ncpa
격동	ncpa
격동상태	ncn
격랑	ncn
격려	ncpa
격려금	ncn
격려문	ncn
격려사	ncn
격려연설	ncpa
격려전화	ncpa
격렬	ncn	ncps
격렬성	ncn
격렬히	mag
격론	ncn
격류	ncn
격률	ncn
격리	ncpa
격리감	ncn
격리수용	ncpa
격리조치	ncn	ncpa
격멸	ncpa
격몽요결	nqq
격무	ncn
격문	ncn
격문법	ncn
격물	ncpa
격물치지	ncpa
격발	ncpa
격변	ncpa
격변기	ncn
격변시기	ncn
격분	ncpa
격상	ncpa
격상조치	ncpa
격세지감	ncn
격식	ncn
격식성	ncn
격심	ncps
격앙	ncpa
격언	ncn
격언행태	ncn
격언형식	ncn
격월	ncn
격의	ncn
격의론	ncn
격일	ncn
격자	ncn	ncpa
격자상	ncn
격자형	ncn
격전	ncpa
격전장	ncn
격전지	ncn
격정	ncn
격조	ncn	ncpa
격조시론	ncn
격주	ncpa
격주문학지	ncn
격증	ncpa
격증현상	ncn
격차	ncn
격차이론	ncn
격차현상	ncn
격찬	ncpa
격추	ncpa
격추사건	ncn
격추사건당시	ncn
격추사고	ncn
격퇴	ncpa
격퇴버튼	ncn
격투	ncpa
격투기	ncn
격투기와	ncn
격틀	ncn
격파	ncpa
격프레임	ncn
격하	ncpa	paa	pvg
격화	ncpa
격화조짐	ncn
겪	pvg
겪기	ncn
겪음	ncn
견	ncn	nqpa
견갑골	ncn
견갑대	ncn
견갑대관절	ncn
견강부회	ncpa
견고	ncn	ncps
견고성	ncn
견고히	mag
견관절	ncn
견구	nqq
견디	pvg
견디기	ncn
견문	ncpa
견물	ncn
견물생심	ncn
견미리	nqq
견본	ncn
견본시	ncn
견본시장	ncn
견본실	ncn
견본제품	ncn
견사	ncn
견상식	nqpc
견섬유	ncn
견성성불	ncpa
견습	ncpa
견습공	ncn
견습기간	ncn
견습기자	ncn
견신	ncn
견신례	ncn
견실	ncps
견실성	ncn
견연옥	nqpc
견오	nqq
견옥숙	nqpc
견원지간	ncn
견인	ncpa
견인내구	ncpa
견인성	ncn
견인역활	ncn
견인차	ncn
견인차량	ncn
견인차역할	ncn
견장	ncn
견적	ncpa
견적서	ncn
견제	ncpa
견제기능	ncn
견제능력	ncn
견제성	ncn
견제세력	ncn
견제시스템	ncn
견제악송구	ncn
견제악송루	ncn
견제역할	ncn
견제의사	ncn
견제장치	ncn	ncpa
견제제스처	ncn
견제조치	ncn	ncpa
견주	pvg
견지	ncn	ncpa
견지동조계사	nqq
견직물	ncn
견질어음	ncn
견찰	ncpa
견책	ncpa
견태수	nqpc
견학	ncpa
견학범위	ncn
견학여행	ncpa
견학코스	ncn
견해	ncn
견해차	ncn
견해차이	ncn
견훤	nqpc
결	nbu	ncn
결가부좌	ncpa
결강	ncpa
결격	ncpa
결격사유	ncn
결격카드	ncn
결과	ncn
결과값	ncn
결과때문	ncn
결과라면	ncn
결과론	ncn
결과물	ncn
결과보고	ncn
결과보고회	ncn
결과본위	ncn
결과상	ncn
결과안내	ncn
결과안내서비스	ncn
결과인지	ncn
결과자료	ncn
결과처리	ncpa
결과출력장치	ncn
결과통지	ncn
결구	ncpa
결국	mag	ncn
결궤	ncpa
결근	ncpa
결단	ncpa
결단내	pvg
결단력	ncn
결단성	ncn
결단식	ncn
결단여하	ncn
결단코	mag
결단행사	ncpa
결단행위	ncpa
결딴	ncn
결락	ncn
결렬	ncpa
결렬원인	ncn
결렬위기	ncn
결례	ncpa
결론	ncn
결론난	ncn
결론내리	pvg
결론맺	pvg
결론부	ncn
결론점	ncn
결론짓	pvg.irrs
결리	pvg
결막염	ncn
결말	ncn
결말부분	ncn
결말짓	pvg.irrs
결명자	ncn
결미부분	ncn
결박	ncpa
결백	ncpa
결벽	ncn
결벽성	ncn
결벽증	ncn
결별	ncpa
결별사유	ncn
결별선언	ncn	ncpa
결별이유	ncn
결부	ncpa
결빙	ncpa
결사	ncpa
결사대	ncn
결사반대	ncpa
결사조직	ncpa
결사투쟁	ncpa
결사항전	ncpa
결산	ncpa
결산결과	ncn
결산기	ncn
결산법인	ncn
결산분배	ncpa
결산분배행사	ncpa
결산서	ncn
결산월	ncn
결석	ncn	ncpa
결석사유	ncn
결석일수	ncn
결선	ncpa
결선진출	ncn
결선투표	ncpa
결선투표법	ncn
결성	ncpa
결성논의	ncpa
결성식	ncn
결성체	ncn
결속	ncpa
결속관계	ncn
결속력	ncn
결손	ncn
결손가정	ncn
결손국가	ncn
결손금처리계산서	ncn
결손부위	ncn
결손아동	ncn
결손액	ncn
결손차액	ncn
결승	ncn	ncpa
결승골	ncn
결승덩크슛	ncn
결승리그	ncn
결승선	ncn
결승전	ncn
결승전서	ncn
결승전이	ncpa
결승점	ncn
결승줄	ncn
결승진출	ncn	ncpa
결승토너	ncn
결승팀	ncn
결승행	ncn
결승홈런	ncn
결시율	ncn
결식노인	ncn
결식아동	ncn
결신	ncn	ncpa
결신자	ncn
결실	ncpa
결실기	ncn
결심	ncpa
결심공판	ncn
결여	ncpa
결연	ncpa	ncps
결연히	mag
결원	ncpa
결의	ncpa
결의권	ncn
결의론	ncn
결의문	ncn
결의사실	ncn
결의사항	ncn
결의안	ncn
결의절차	ncn
결의채택	ncpa
결의형제	ncn
결인	ncn
결장	ncn
결장질병	ncn
결재	ncpa
결재권한	ncn
결재기한	ncn
결재라인	ncn
결재서류	ncn
결재여부	ncn
결재일	ncn
결전	ncpa
결절	ncn
결절기관	ncn
결절작용	ncpa
결절점	ncn
결점	ncn
결정	ncn	ncpa
결정계획	ncpa
결정고시	ncn
결정과정	ncn	ncpa
결정구조	ncn
결정권	ncn
결정권자	ncn
결정권한	ncn
결정기구	ncn
결정기능	ncn
결정내역	ncn
결정내용	ncn
결정능력	ncn
결정론	ncn
결정무산	ncn
결정문	ncn
결정문재	ncn
결정문제	ncn
결정방식	ncn
결정사안	ncn
결정사진	ncn
결정사항	ncn
결정서	ncn
결정선고	ncpa
결정센서	ncn
결정수	ncn
결정시기	ncn
결정요건	ncn
결정요소	ncn
결정요인	ncn
결정이유	ncn
결정인자	ncn
결정전	ncn
결정절차	ncn
결정짓	pvg.irrs
결정체	ncn
결정타	ncn
결정통지	ncpa
결정투표	ncn	ncpa
결정판	ncn
결정패턴	ncn
결정환경	ncn
결제	ncn
결제기간	ncn
결제기일	ncn
결제대금조회	ncn
결제방법	ncn
결제방식	ncn
결제수단	ncn
결제시	ncn
결제시기	ncn
결제원	nqq
결제일	ncn
결제일다원화정책	ncn
결제자금	ncn
결제조건	ncn
결제체제론	ncn
결제통화	ncn
결집	ncpa
결집회의	ncn
결체조직	ncpa
결코	mag
결탁	ncpa
결투	ncpa
결판	ncpa
결핍	ncpa
결핍현상	ncn
결하	paa	pvg
결함	ncn
결함원인	ncn
결함허용기능지원	ncpa
결합	ncpa
결합계이론	ncn
결합관계	ncpa
결합구조	ncn
결합국가	ncn
결합기술	ncn
결합기호	ncn
결합노동	ncpa
결합력	ncn
결합방식	ncn
결합상	ncn
결합상태	ncn
결합운동	ncpa
결합유형	ncn
결합자체	ncn
결합조직	ncpa
결합체	ncn
결합현상	ncn
결합형식	ncn
결합형태	ncn
결항	ncn